The smell of burning electronics hits your lizard hindbrain like a rivet gun and you awaken almost immediately, limbs flailing against the sides of the coffin. A badly-milled bolt opens a bloody streak on the back of your wrist, and several seconds pass before you realize you can't feel it because you're completely numb.
 ...
 The smoke smell drifts by your nose again, a little stronger. You startle and bark your forehead on the plastex window above you. The pain keeps you awake this time.

Silent Stars
An Interactive Fiction by Zaq Grow
Release 1 / Serial number 130323 / Inform 7 build 6G60 (I6/v6.32 lib 6/12N) SD

Antiseptic Coffin, in the gloom
You're lying down inside a metal coffin that isn't much larger than you. It (you?) reeks of medical disinfectants; the fuzziness in your head feels like it's keeping away a headache from all the fumes.

A small plastex window is set into the hatch above you.

The control panel above you shows a blinking red button.

The control panel reveals an alarm clock.

>press cycle
The button changes to green and blinks "Completed" a couple times.

* * *

>press exit
A beat passes, and then the gasket on the autodoc's hatch disengages with a whoosh of pressurized air. The stench of old blood quickly replaces the tang of disinfectants.

You open the hatch.

>out
Medical Bay, in the darkness
The Medical Bay has no description in the dark.

>in
Antiseptic Coffin, in dim light
You're lying down inside a metal coffin that isn't much larger than you. It (you?) reeks of medical disinfectants; the fuzziness in your head feels like it's keeping away a headache from all the fumes.

A small plastex window is set into the hatch above you.

The control panel above you shows a blinking red button.

The control panel shows an alarm clock.

>out
Antiseptic Coffin, in the shadows
The Medical Bay has no description in the dark.

>in
Antiseptic Coffin, in dim light
You're lying down inside a metal coffin that isn't much larger than you. It (you?) reeks of medical disinfectants; the fuzziness in your head feels like it's keeping away a headache from all the fumes.

A small plastex window is set into the hatch above you.

The control panel above you shows a blinking red button.

The lightness from the control panel illuminates an alarm clock.

>rules
Rules tracing now switched on. Type "rules off" to switch it off again, or "rules all" to include even rules which do not apply.

>out
[Rule "Setting action variables for exiting" applies.]
[Rule "convert exit into go out rule" applies.]
[Rule "standard set going variables rule" applies.]
[Rule "can't travel in what's not a vehicle rule" applies.]
[Rule "can't go through undescribed doors rule" applies.]
[Rule "can't go through closed doors rule" applies.]
[Rule "determine map connection rule" applies.]
[Rule "can't go that way rule" applies.]
[Rule "move player and vehicle rule" applies.]
[Rule "move floating objects rule" applies.]
[Rule "check light in new location rule" applies.]
[Rule "describe room gone into rule" applies.]

[Rule "determine visibility ceiling rule" applies.]
[Rule "room description heading rule" applies.]

[Rule "new room-name rule" applies.]
Antiseptic Coffin, in the gloom
[Rule "room description body text rule" applies.]
The Medical Bay has no description in the dark.
[Rule "room description paragraphs about objects rule" applies.]
[Rule "replacement arrival check rule" applies.]
[Rule "mark items as seen when looking rule" applies.]
[Rule "other people looking rule" applies.]

* * *

>out
Medical Bay, in the darkness
The Medical Bay has no description in the dark.

>listen
the radio emits an unbroken stream of static.

>soundcheck radio
radio:
Is it audible? yes
Clamorous
Medical Bay
Heard things: radio
Audible things: radio

>soundcheck clock
alarm clock:
Is it audible? no
Noisy
Antiseptic Coffin
Heard things: radio
Audible things: radio

* * *

>listne
That's not a verb I recognise.

>listen
The alarm clock beeps incessantly.
Nearby, the radio emits an unbroken stream of static.

>listen east
I only understood you as far as wanting to listen.