Silent Stars
An Interactive Fiction by Zaq Grow
Release 1 / Serial number 130405 / Inform 7 build 6G60 (I6/v6.32 lib 6/12N) SD

craggy rocks, in the shadows
(DARK DESC)
1
2
Nothing lies behind.

Still water cools the air.
It seems to stretch forever.
No waves touch your feet.

>press cycle
The button changes to green and blinks "Completed" a couple times.

>press unlock
The "Unlock Hatch" button changes to green.

>press exit
A beat passes, and then the gasket on the autodoc's hatch disengages with a whoosh of pressurized air. The stench of old blood quickly replaces the tang of disinfectants.

You open the htcah.

>out
Medical Bay, in the darkness
The Medical Bay has no description in the dark.

* * *

Silent Stars
An Interactive Fiction by Zaq Grow
Release 1 / Serial number 130405 / Inform 7 build 6G60 (I6/v6.32 lib 6/12N) SD

craggy rocks, in the shadows
(DARK DESC)
1
2
Nothing lies behind.

Still water cools the air.
It seems to stretch forever.
No waves touch your feet.

>z
Time passes.

A shining stone falls.
The water glows with pale light.
Ripples lap the shore.

>z
Time passes.

The pale gleam recedes.
Inky dark cloaks the water.
The waves quiet down.

>z
Time passes.

>z
Time passes.

>take onion
Taken.

>give onion to max
"Thanks, hon." He picks his knife back up and slices off the top and bottom of the onion.

>z
Time passes.

Max slices the onion in half and pulls the skins off, then sets to with the knifeblade. He still needs practice; those years as an artist didn't come with cooking lessons.

>z
Time passes.

>z
Time passes.

Max takes the diced onion and mounds it into another waiting bowl.

>z
Time passes.

>z
Time passes.

He holds the bowl out to you. "Could you take a look at this, see how I did?"

* * *

>z
Time passes.

>listen
You hear only the silence of a scuttled ship.

>x darkness
It is pitch dark, and you can't see a thing.

>x nothing
It is pitch dark, and you can't see a thing.

>x water
It is pitch dark, and you can't see a thing.

>look down
It is pitch dark, and you can't see a thing.

>rules
Rules tracing now switched on. Type "rules off" to switch it off again, or "rules all" to include even rules which do not apply.

>look
[Rule "determine visibility ceiling rule" applies.]
[Rule "room description heading rule" applies.]
[Rule "new room-name rule" applies.]
jagged rocks, in the gloom
[Rule "room description body text rule" applies.]
Darkness on all sides.
Chill water lies at your feet.
Nothing lies behind.
[Rule "room description paragraphs about objects rule" applies.]
[Rule "replacement arrival check rule" applies.]
[Rule "mark items as seen when looking rule" applies.]
[Rule "other people looking rule" applies.]

>x darkness
[Rule "After deciding the scope of the player while the location is in Dreamspace" applies.]
It is pitch dark, and you can't see a thing.

>actions
Actions listing on.

>x darkness
[Rule "After deciding the scope of the player while the location is in Dreamspace" applies.]
[examining nothing]
It is pitch dark, and you can't see a thing.
[examining nothing - failed the basic visibility rule]

>x stone
[Rule "After deciding the scope of the player while the location is in Dreamspace" applies.]
[examining the stone]
[Rule "Before examining the stone" applies.]
Admired at range,
the stone's glow waxes and wanes
like a  tiny moon.
[examining the stone - ended without result]

* * *

>z
Time passes.

The pale gleam recedes.
Inky dark cloaks the water.
The waves quiet down.

>lumos
{{The light level in the cracked rocks qualifies for: }}
{{Light-bearing things: nothing}}

* * *

>z
Time passes.

The pale gleam recedes.
Inky dark cloaks the water.
The waves quiet down.

>x water
You can't see any such thing.

>showme water
water - backdrop
location: in the craggy rocks
singular-named, improper-named; unlit, inedible, fixed in place, scenery, neuter, ordinarily enumerated, unseen, unfamiliar, mundane, unexamined, cold, dim, diffuse, infrared
printed name: "water"
printed plural name: "backdrops"
indefinite article: "the"
description: "You dip your fingers.
Deathly cold, then painful heat.
You flinch back, anxious.

Down below, a stone.
It glows like a faint firefly.
Pale white, and fading."
initial appearance: none
bulk: 1
dark-description: "You dip your fingers.
Deathly cold, then painful heat.
You flinch back, anxious.

Down below, a stone.
It glows like a faint firefly.
Pale white, and fading."
sound: "silence"
sound-description: "This does not make noise."

>x water
You can't see any such thing.

* * *

Silent Stars
An Interactive Fiction by Zaq Grow
Release 1 / Serial number 130405 / Inform 7 build 6G60 (I6/v6.32 lib 6/12N) SD

craggy rocks, in the shadows
(DARK DESC)
1
2
Nothing lies behind.

Still water cools the air.
It seems to stretch forever.
No waves touch your feet.

>x water
You dip your fingers.
Deathly cold, then painful heat.
You flinch back, anxious.

A shining stone falls.

The water glows with pale light.
Ripples lap the shore.

>x nothing
In nothing, stillness.
Fear and curiousity.
Turn lightward for now.

>x water
You must supply a noun.

>showme water
water - transparent open container
    stone
location: in (Inside)
singular-named, improper-named; unlit, inedible, fixed in place, neuter, ordinarily enumerated, seen, unfamiliar, mundane, unexamined, cold, dim, diffuse; transparent, open, unopenable, unlocked
printed name: "water"
printed plural name: "containers"
indefinite article: "the"
description: "You dip your fingers.
Deathly cold, then painful heat.
You flinch back, anxious.
"
initial appearance: "Still water cools the air.
It seems to stretch forever.
No waves touch your feet.
"
bulk: 1
dark-description: "The water has no description in the dark."
sound: "silence"
sound-description: "This does not make noise."
carrying capacity: 100
bulk capacity: 10

* * *

>x nothing
In nothing, stillness.
Fear and curiousity.
Turn lightward for now.

>x darkness
In nothing, stillness.
Fear and curiousity.
Turn lightward for now.

>x stone
Admired at range,
the stone's glow waxes and wanes
like a  tiny moon.

* * *

>x water
You dip your fingers.
Deathly cold, then painful heat.
You flinch back, anxious.

A shining stone falls.

The water glows with pale light.
Ripples lap the shore.

>drink water
You dip your fingers.
Deathly cold, then painful heat.
You flinch back, anxious.

In the water is a stone.

(Inside)
Darkness on all sides.
Chill water lies at your feet.
Nothing lies behind.

Still water cools the air.
It seems to stretch forever.
No waves touch your feet.

>take water
You dip your fingers.
Deathly cold, then painful heat.
You flinch back, anxious.

In the water is a stone.

>x stone
You see nothing special about the stone.

>z
Time passes.

* * *

>x water
You dip your fingers.
Deathly cold, then painful heat.
You flinch back, anxious.

A shining stone falls.

The water glows with pale light.
Ripples lap the shore.

>x stone
Admired at range,
the stone's glow waxes and wanes
like a  tiny moon.

craggy rocks
Darkness on all sides.
Chill water lies at your feet.
Nothing lies behind.

>take stone
You crouch down and reach.

It's like bare skin in deep space.

Sensation departs.

Struggling brings nothing.

To reach it, you must dive in.

Commit, all or none.

>take stone
Struggling brings nothing.

To reach it, you must dive in.

Commit, all or none.

* * *

>x stone
Admired at range,
the stone's glow waxes and wanes
like a  tiny moon.

craggy rocks
Darkness on all sides.
Chill water lies at your feet.
Nothing lies behind.

>x water
You dip your fingers.
Deathly cold, then painful heat.
You flinch back, anxious.

Down below, a stone.
It glows like a faint firefly.
Pale white, and fading.

>down
upper pool
The upper pool has no description in the dark.

>x water
Blacker than midnight.
The chill reaches through your skin.
Your limbs feel distant.

Down below, a stone.
It glows like a faint firefly.
Pale white, and fading.

upper pool

>u
gravelly rocks
Darkness on all sides.
Chill water lies at your feet.
Nothing lies behind.

>look down
You gaze downwards.

>rules
Rules tracing now switched on. Type "rules off" to switch it off again, or "rules all" to include even rules which do not apply.

>look down
[Rule "After deciding the scope of the player while the location is in Dreamspace" applies.]
[Rule "standard examining rule" applies.]
[Rule "new examine directions rule" applies.]
You gaze downwards.

[Rule "examine containers rule" applies.]
[Rule "examine supporters rule" applies.]
[Rule "examine devices rule" applies.]
[Rule "examine undescribed things rule" applies.]
[Rule "report other people examining rule" applies.]

* * *

>x water
You dip your fingers.
Deathly cold, then painful heat.
You flinch back, anxious.

A shining stone falls.

The water glows with pale light.
Ripples lap the shore.

>take stone
You plunge a hand in.
 It's like bare skin in deep space.
 Sensation departs.

You can't reach into the upper pool.

The pale gleam recedes.
Inky dark cloaks the water.
The waves settle down.

>x stone
Admired at range,
the stone's glow waxes and wanes
like a  tiny moon.

>look
craggy rocks, in the darkness
1
2
Nothing lies behind.

Still water cools the air.
It seems to stretch forever.
No waves touch your feet.

>dive in
That's not a verb I recognise.

* * *

>take stone
You plunge a hand in.
 It's like bare skin in deep space.
 Sensation departs.

You can't reach into the upper pool.

The pale gleam recedes.
Inky dark cloaks the water.
The waves settle down.

>x nothing
In nothing, stillness.
Fear and curiousity.
Turn lightward for now.

>dive i
I only understood you as far as wanting to dive.

>dive in
HAIKUS HERE.

upper pool, in the gloom
(DARK DESC)
The water is still.
 Shadows crowd in overhead.
 The silence deafens.

>dive
HAIKUS HERE.

lower pool, in dim light
The bottom is smooth.
 No signs of life scar the mud.
 Your guts feel frostbit.

Before you, a stone.
It glows like a faint firefly.
Pale white, and fading.

>x stone
Admired at range,
the stone's glow waxes and wanes
like a  tiny moon.

>take stone
Taken.

>x stone
Ivory colored quartz.
Cloudy, like a summer day.
Warmer than skin heat.

>d
You can't go that way.

>look
lower pool, in dim light
The bottom is smooth.
 No signs of life scar the mud.
 Your guts feel frostbit.

>u
upper pool, in dim light
The water is still.
 Shadows crowd in overhead.
 The silence deafens.

* * *

>x water
You dip your fingers.
Deathly cold, then painful heat.
You flinch back, anxious.

A shining stone falls.

The water glows with pale light.
Ripples lap the shore.

>purloin stone
[Purloined.]

>x water
You dip your fingers.
Deathly cold, then painful heat.
You flinch back, anxious.

>i
You are carrying:
  a stone (providing light)

>rules
Rules tracing now switched on. Type "rules off" to switch it off again, or "rules all" to include even rules which do not apply.

>i
[Rule "print empty inventory rule" applies.]
[Rule "print standard inventory rule" applies.]
You are carrying:
  a stone (providing light)

[Rule "report other people taking inventory rule" applies.]

* * *

>x water
You dip your fingers.
Deathly cold, then painful heat.
You flinch back, anxious.

A shining stone falls.

The water glows with pale light.
Ripples lap the shore.

>dive in
One breath, plus one held.

 Even your bones feel like ice.

 Darkness shrouds your thoughts.

(Inside), in dim light (in the water)
Darkness on all sides.
Chill water lies at your feet.
Nothing lies behind.

In water, a stone.
It glows like a faint firefly.
Pale white, and fading.

* * *

>x water
You dip your fingers.
Deathly cold, then painful heat.
You flinch back, anxious.

A shining stone falls.

The water glows with pale light.
Ripples lap the shore.

>down
upper pool
The upper pool has no description in the dark.

>up
rocky shore line
Darkness on all sides.
Chill water lies at your feet.
Nothing lies behind.

>x down
You see nothing unexpected in that direction.

rocky shore line
Darkness on all sides.
Chill water lies at your feet.
Nothing lies behind.

* * *

>down
upper pool
The upper pool has no description in the dark.

>x water
You dip your fingers.
Deathly cold, then painful heat.
You flinch back, anxious.

Down below, a stone.
It glows like a faint firefly.
Pale white, and fading.

upper pool

>up
jagged rocks
Darkness on all sides.
Chill water lies at your feet.
Nothing lies behind.

>x water
You dip your fingers.
Deathly cold, then painful heat.
You flinch back, anxious.

Down below, a stone.
It glows like a faint firefly.
Pale white, and fading.

sharp rocks
Darkness on all sides.
Chill water lies at your feet.
Nothing lies behind.

>x water
You dip your fingers.
Deathly cold, then painful heat.
You flinch back, anxious.

Down below, a stone.
It glows like a faint firefly.
Pale white, and fading.

>d
upper pool

>x water
You dip your fingers.
Deathly cold, then painful heat.
You flinch back, anxious.

Down below, a stone.
It glows like a faint firefly.
Pale white, and fading.

>u
jagged rocks
Darkness on all sides.
Chill water lies at your feet.
Nothing lies behind.

>x water
You dip your fingers.
Deathly cold, then painful heat.
You flinch back, anxious.

Down below, a stone.
It glows like a faint firefly.
Pale white, and fading.

* * *

>x water
You dip your fingers.
Deathly cold, then painful heat.
You flinch back, anxious.

A shining stone falls.

The water glows with pale light.
Ripples lap the shore.

>x down
You gaze downwards.

Still water cools the air.
It seems to stretch forever.
No waves touch your feet.
a rocky shore line
Darkness on all sides.
Chill water lies at your feet.
Nothing lies behind.

>down
water
Still water cools the air.
It seems to stretch forever.
No waves touch your feet.

In water, a stone.
It glows like a faint firefly.
Pale white, and fading.

* * *

>x water
You dip your fingers.
Deathly cold, then painful heat.
You flinch back, anxious.

A shining stone falls.

The water glows with pale light.
Ripples lap the shore.

>showme water
water - backdrop
location: out of play
singular-named, improper-named; unlit, inedible, fixed in place, scenery, neuter, ordinarily enumerated, unseen, unfamiliar, mundane, unexamined, cold, dim, diffuse
printed name: "water"
printed plural name: "backdrops"
indefinite article: "the"
description: "You dip your fingers.
Deathly cold, then painful heat.
You flinch back, anxious.

Down below, a stone.
It glows like a faint firefly.
Pale white, and fading."
initial appearance: none
bulk: 1
dark-description: "The water has no description in the dark."
sound: "silence"
sound-description: "This does not make noise."

>regions
That's not a verb I recognise.

>region
That's not a verb I recognise.

>showme Dreamspace
Dreamspace - region
singular-named, improper-named
printed name: "Dreamspace"
printed plural name: "regions"
indefinite article: none

>showme rocky shore
jagged rocks - room
    yourself - person
        left hand (part of yourself)
        right hand (part of yourself)
    nothing
singular-named, improper-named; dark, visited
printed name: "cracked rocks"
printed plural name: none
indefinite article: none
description: "Darkness on all sides.
Chill water lies at your feet.
Nothing lies behind."
map region: Dreamspace
dark-description: "Darkness on all sides.
Chill water lies at your feet.
Nothing lies behind."
sound: "silence"
sound-description: "Total silence."

* * *

>down
upper pool
The upper pool has no description in the dark.

>up
craggy rocks
Darkness on all sides.
Chill water lies at your feet.
Nothing lies behind.

>x water
You dip your fingers.
Deathly cold, then painful heat.
You flinch back, anxious.

Down below, a stone.
It glows like a faint firefly.
Pale white, and fading.

cracked rocks
Darkness on all sides.
Chill water lies at your feet.
Nothing lies behind.

>showme water
water - backdrop
location: in the sharp rocks
singular-named, improper-named; unlit, inedible, fixed in place, scenery, neuter, ordinarily enumerated, seen, familiar, mundane, unexamined, cold, dim, diffuse
printed name: "water"
printed plural name: "backdrops"
indefinite article: "the"
description: "You dip your fingers.
Deathly cold, then painful heat.
You flinch back, anxious.

Down below, a stone.
It glows like a faint firefly.
Pale white, and fading."
initial appearance: none
bulk: 1
dark-description: "The water has no description in the dark."
sound: "silence"
sound-description: "This does not make noise."

* * *

>x water
You dip your fingers.
Deathly cold, then painful heat.
You flinch back, anxious.

A shining stone falls.

The water glows with pale light.
Ripples lap the shore.

>z
Time passes.

>x water
You can't see any such thing.

>d
upper pool
The upper pool has no description in the dark.

>u
gravelly rocks
Darkness on all sides.
Chill water lies at your feet.
Nothing lies behind.

>x water
You see nothing special about the water.

* * *

>z
Time passes.

>z
Time passes.

In darkness, a gleam:
A stone falls in the water.

Ripples lap the shore.

>x stone
Admired at range,
the stone's glow waxes and wanes
like a  tiny moon.

>x water
You can't see any such thing.

* * *

>x water
You dip your fingers.
Deathly cold, then painful heat.
You flinch back, anxious.

A shining stone falls.

The water glows with pale light.
Ripples lap the shore.

>d
upper pool
The upper pool has no description in the dark.

I beg your pardon?

>u
gravelly rocks
Darkness on all sides.
Chill water lies at your feet.
Nothing lies behind.

>x water
You dip your fingers.
Deathly cold, then painful heat.
You flinch back, anxious.

Down below, a stone.
It glows like a faint firefly.
Pale white, and fading.

sharp rocks
Darkness on all sides.
Chill water lies at your feet.
Nothing lies behind.

* * *

>d
upper pool
The upper pool has no description in the dark.

>u
craggy rocks
Darkness on all sides.
Chill water lies at your feet.
Nothing lies behind.

>x water
You dip your fingers.
Deathly cold, then painful heat.
You flinch back, anxious.

Down below, a stone.
It glows like a faint firefly.
Pale white, and fading.

cracked rocks
Darkness on all sides.
Chill water lies at your feet.
Nothing lies behind.

* * *

>x water
You dip your fingers.
Deathly cold, then painful heat.
You flinch back, anxious.

A shining stone falls.

The water glows with pale light.
Ripples lap the shore.

>look down
You gaze downwards.

The water is still.
 Shadows crowd in overhead.
 The silence deafens.
jagged rocks
Darkness on all sides.
Chill water lies at your feet.
Nothing lies behind.

* * *

>x water
You dip your fingers.
Deathly cold, then painful heat.
You flinch back, anxious.

A shining stone falls.

The water glows with pale light.
Ripples lap the shore.

>x water
You dip your fingers.
Deathly cold, then painful heat.
You flinch back, anxious.

The pale gleam recedes.
Inky dark cloaks the water.
The waves settle down.

>x water
You dip your fingers.
Deathly cold, then painful heat.
You flinch back, anxious.

Down below, a stone.
It glows like a faint firefly.
Pale white, and fading.

* * *

Silent Stars
An Interactive Fiction by Zaq Grow
Release 1 / Serial number 130405 / Inform 7 build 6G60 (I6/v6.32 lib 6/12N) SD

craggy rocks, in the shadows
(DARK DESC)
1
2
Nothing lies behind.

Still water cools the air.
It seems to stretch forever.
No waves touch your feet.

>x
(nothing)
In nothing, stillness.
Fear and curiousity.
Turn lightward for now.

>x nothing
In nothing, stillness.
Fear and curiousity.
Turn lightward for now.

(Inside)
Darkness on all sides.
Chill water lies at your feet.
Nothing lies behind.

In nothing, stillness.
Fear and curiousity.
Turn lightward for now.

Still water cools the air.
It seems to stretch forever.
No waves touch your feet.

* * *

>x
(nothing)
In nothing, stillness.
Fear and curiousity.
Turn lightward for now.

>nothing
You can't see any such thing.

>showme dreamspace
(Inside) - room
    yourself - person
        left hand (part of yourself)
        right hand (part of yourself)
    water - transparent open container
        stone
singular-named, proper-named; dark, visited
printed name: "(Inside)"
printed plural name: none
indefinite article: none
description: "Darkness on all sides.
Chill water lies at your feet.
Nothing lies behind.
"
dark-description: "Darkness on all sides.
Chill water lies at your feet.
Nothing lies behind.
"
sound: "silence"
sound-description: "Total silence."

* * *

>x
(nothing)
In nothing, stillness.
Fear and curiousity.
Turn lightward for now.

>z
Time passes.

(Inside)
Darkness on all sides.
Chill water lies at your feet.
Nothing lies behind.

Still water cools the air.
It seems to stretch forever.
No waves touch your feet.

>x water
You must supply a noun.

* * *

Silent Stars
An Interactive Fiction by Zaq Grow
Release 1 / Serial number 130405 / Inform 7 build 6G60 (I6/v6.32 lib 6/12N) SD

craggy rocks, in the shadows
(DARK DESC)
1
2
Nothing lies behind.

Still water cools the air.
It seems to stretch forever.
No waves touch your feet.

>rules
Rules tracing now switched on. Type "rules off" to switch it off again, or "rules all" to include even rules which do not apply.

>x
[Rule "After deciding the scope of the player while the player is in Dreamspace" applies.]
(the sunrod)
[Rule "standard examining rule" applies.]
[Rule "examine directions rule" applies.]
[Rule "examine containers rule" applies.]
[Rule "examine supporters rule" applies.]
[Rule "examine devices rule" applies.]
The sunrod is currently switched off.

[Rule "examine undescribed things rule" applies.]
[Rule "report other people examining rule" applies.]

* * *

>rules
Rules tracing now switched on. Type "rules off" to switch it off again, or "rules all" to include even rules which do not apply.

>x water
[Rule "After deciding the scope of the player while the player is in Dreamspace" applies.]
[Rule "Before doing something with the water" applies.]
[Rule "After deciding the scope of the player while the player is in Dreamspace" applies.]
[Rule "mark items as seen on examining rule" applies.]
[Rule "standard examining rule" applies.]
You dip your fingers.
Deathly cold, then painful heat.
You flinch back, anxious.

[Rule "examine directions rule" applies.]
[Rule "examine containers rule" applies.]
In the water is a stone.

[Rule "examine supporters rule" applies.]
[Rule "examine devices rule" applies.]
[Rule "examine undescribed things rule" applies.]
[Rule "report other people examining rule" applies.]

* * *

>rules
Rules tracing now switched on. Type "rules off" to switch it off again, or "rules all" to include even rules which do not apply.

>actions
Actions listing on.

>look down
[Rule "After deciding the scope of the player while the location is in Dreamspace" applies.]
[examining down]
[Rule "standard examining rule" applies.]
[Rule "new examine directions rule" applies.]
Still water cools the air.
It seems to stretch forever.
No waves touch your feet.
[Rule "examine containers rule" applies.]
[Rule "examine supporters rule" applies.]
[Rule "examine devices rule" applies.]
[Rule "examine undescribed things rule" applies.]
[Rule "report other people examining rule" applies.]
[examining down - succeeded]

>x water
[Rule "After deciding the scope of the player while the location is in Dreamspace" applies.]
You can't see any such thing.

>jump
[jumping]
[Rule "block jumping rule" applies.]
You jump on the spot, fruitlessly.
[jumping - failed the block jumping rule]

[Rule "determine visibility ceiling rule" applies.]
[looking]
[Rule "room description heading rule" applies.]
a rocky shore line
[Rule "room description body text rule" applies.]
Darkness on all sides.
Chill water lies at your feet.
Nothing lies behind.

[Rule "room description paragraphs about objects rule" applies.]
[Rule "don't mention player's supporter in room descriptions rule" applies.]
[Rule "don't mention scenery in room descriptions rule" applies.]
[Rule "don't mention undescribed items in room descriptions rule" applies.]
[Rule "set pronouns from items in room descriptions rule" applies.]
[Rule "offer items to writing a paragraph about rule" applies.]
[Rule "use initial appearance in room descriptions rule" applies.]
[Rule "don't mention player's supporter in room descriptions rule" applies.]
[Rule "don't mention scenery in room descriptions rule" applies.]
[Rule "don't mention undescribed items in room descriptions rule" applies.]
[Rule "set pronouns from items in room descriptions rule" applies.]
[Rule "offer items to writing a paragraph about rule" applies.]
[Rule "use initial appearance in room descriptions rule" applies.]
[Rule "replacement arrival check rule" applies.]
[Rule "mark items as seen when looking rule" applies.]
[Rule "other people looking rule" applies.]
[looking - succeeded]

* * *

>actions
Actions listing on.

>rules all
Rules tracing now switched to "all". Type "rules off" to switch it off again.

>z
[Rule "standard set going variables rule" does not apply.]
[Rule "determine visibility ceiling rule" does not apply.]
[Rule "Setting action variables for exiting" does not apply.]
[waiting]
[Rule "Before going through a closed hatch ( called the blocking hatch )" does not apply.]
[Rule "Before examining the stone" does not apply.]
[Rule "Before opening the Autodoc's hatch" does not apply.]
[Rule "Instead of pushing the cycle button" does not apply.]
[Rule "Instead of pushing the unlock button" does not apply.]
[Rule "Instead of pushing the exit button" does not apply.]
[Rule "Instead of pushing a button ( called the frobber )" does not apply.]
[Rule "standard report waiting rule" applies.]
Time passes.
[waiting - succeeded]

>z
[Rule "standard set going variables rule" does not apply.]
[Rule "determine visibility ceiling rule" does not apply.]
[Rule "Setting action variables for exiting" does not apply.]
[waiting]
[Rule "Before going through a closed hatch ( called the blocking hatch )" does not apply.]
[Rule "Before examining the stone" does not apply.]
[Rule "Before opening the Autodoc's hatch" does not apply.]
[Rule "Instead of pushing the cycle button" does not apply.]
[Rule "Instead of pushing the unlock button" does not apply.]
[Rule "Instead of pushing the exit button" does not apply.]
[Rule "Instead of pushing a button ( called the frobber )" does not apply.]
[Rule "standard report waiting rule" applies.]
Time passes.
[waiting - succeeded]

[Rule "standard set going variables rule" does not apply.]
[Rule "determine visibility ceiling rule" applies.]
[Rule "Setting action variables for exiting" does not apply.]
[looking]
[Rule "Before going through a closed hatch ( called the blocking hatch )" does not apply.]
[Rule "Before examining the stone" does not apply.]
[Rule "Before opening the Autodoc's hatch" does not apply.]
[Rule "Instead of pushing the cycle button" does not apply.]
[Rule "Instead of pushing the unlock button" does not apply.]
[Rule "Instead of pushing the exit button" does not apply.]
[Rule "Instead of pushing a button ( called the frobber )" does not apply.]
[Rule "room description heading rule" applies.]
jagged rocks
[Rule "room description body text rule" applies.]
Darkness on all sides.
Chill water lies at your feet.
Nothing lies behind.

[Rule "room description paragraphs about objects rule" applies.]
[Rule "don't mention player's supporter in room descriptions rule" applies.]
[Rule "don't mention scenery in room descriptions rule" applies.]
[Rule "don't mention undescribed items in room descriptions rule" applies.]
[Rule "set pronouns from items in room descriptions rule" applies.]
[Rule "offer items to writing a paragraph about rule" applies.]
[Rule "use initial appearance in room descriptions rule" applies.]
[Rule "don't mention player's supporter in room descriptions rule" applies.]
[Rule "don't mention scenery in room descriptions rule" applies.]
[Rule "don't mention undescribed items in room descriptions rule" applies.]
[Rule "set pronouns from items in room descriptions rule" applies.]
[Rule "offer items to writing a paragraph about rule" applies.]
[Rule "use initial appearance in room descriptions rule" applies.]
[Rule "replacement arrival check rule" applies.]
[Rule "mark items as seen when looking rule" applies.]
[Rule "other people looking rule" applies.]
[looking - succeeded]

* * *

>rules
Rules tracing now switched on. Type "rules off" to switch it off again, or "rules all" to include even rules which do not apply.

>z
[Rule "standard report waiting rule" applies.]
Time passes.

>z
[Rule "standard report waiting rule" applies.]
Time passes.

[Rule "determine visibility ceiling rule" applies.]
[Rule "room description heading rule" applies.]
sharp rocks
[Rule "room description body text rule" applies.]
Darkness on all sides.
Chill water lies at your feet.
Nothing lies behind.

[Rule "room description paragraphs about objects rule" applies.]
[Rule "don't mention player's supporter in room descriptions rule" applies.]
[Rule "don't mention scenery in room descriptions rule" applies.]
[Rule "don't mention undescribed items in room descriptions rule" applies.]
[Rule "set pronouns from items in room descriptions rule" applies.]
[Rule "offer items to writing a paragraph about rule" applies.]
[Rule "use initial appearance in room descriptions rule" applies.]
[Rule "don't mention player's supporter in room descriptions rule" applies.]
[Rule "don't mention scenery in room descriptions rule" applies.]
[Rule "don't mention undescribed items in room descriptions rule" applies.]
[Rule "set pronouns from items in room descriptions rule" applies.]
[Rule "offer items to writing a paragraph about rule" applies.]
[Rule "use initial appearance in room descriptions rule" applies.]
[Rule "don't mention player's supporter in room descriptions rule" applies.]
[Rule "don't mention scenery in room descriptions rule" applies.]
[Rule "don't mention undescribed items in room descriptions rule" applies.]
[Rule "set pronouns from items in room descriptions rule" applies.]
[Rule "offer items to writing a paragraph about rule" applies.]
[Rule "use initial appearance in room descriptions rule" applies.]
[Rule "replacement arrival check rule" applies.]
[Rule "mark items as seen when looking rule" applies.]
[Rule "other people looking rule" applies.]

* * *

Silent Stars
An Interactive Fiction by Zaq Grow
Release 1 / Serial number 130405 / Inform 7 build 6G60 (I6/v6.32 lib 6/12N) SD

craggy rocks, in the shadows
(DARK DESC)
1
2
Nothing lies behind.

Still water cools the air.
It seems to stretch forever.
No waves touch your feet.

>x stone
Admired at range,
the stone's glow waxes and wanes
like a  tiny moon.

>look
(Inside)
Darkness on all sides.
Chill water lies at your feet.
Nothing lies behind.

Still water cools the air.
It seems to stretch forever.
No waves touch your feet.

* * *

>x stone
Admired at range,
the stone's glow waxes and wanes
like a  tiny moon.

>x down
You gaze downwards.

craggy rocks
Darkness on all sides.
Chill water lies at your feet.
Nothing lies behind.

>x nothing
In nothing, stillness.
Fear and curiousity.
Turn lightward for now.

>x water
You can't see any such thing.

>showme rocky shore
jagged rocks - room
    yourself - person
        left hand (part of yourself)
        right hand (part of yourself)
    nothing
singular-named, improper-named; lighted, visited
printed name: "sharp rocks"
printed plural name: none
indefinite article: none
description: "Darkness on all sides.
Chill water lies at your feet.
Nothing lies behind."
map region: Dreamspace
dark-description: "Darkness on all sides.
Chill water lies at your feet.
Nothing lies behind."
sound: "silence"
sound-description: "Total silence."

>showme water
water - backdrop
location: out of play
singular-named, improper-named; unlit, inedible, fixed in place, scenery, neuter, ordinarily enumerated, unseen, unfamiliar, mundane, unexamined, cold, dim, diffuse
printed name: "water"
printed plural name: "backdrops"
indefinite article: none
description: "You dip your fingers.
Deathly cold, then painful heat.
You flinch back, anxious.

Down below, a stone.
It glows like a faint firefly.
Pale white, and fading."
initial appearance: none
bulk: 1
dark-description: "The water has no description in the dark."
sound: "silence"
sound-description: "This does not make noise."

* * *

>x stone
Admired at range,
the stone's glow waxes and wanes
like a  tiny moon.

>x nothing
It is pitch dark, and you can't see a thing.

* * *

Silent Stars
An Interactive Fiction by Zaq Grow
Release 1 / Serial number 130405 / Inform 7 build 6G60 (I6/v6.32 lib 6/12N) SD

craggy rocks, in the shadows
(DARK DESC)
1
2
Nothing lies behind.

Still water cools the air.
It seems to stretch forever.
No waves touch your feet.

>look
craggy rocks, in the darkness
(DARK DESC)
1
2
Nothing lies behind.

Still water cools the air.
It seems to stretch forever.
No waves touch your feet.

A shining stone falls.
The water glows with pale light.
Ripples lap the shore.

>x stone
You see nothing special about the stone.

>lumos
{{The light level in the (Inside) qualifies for: dim }}
{{Light-bearing things: stone}}

>x water
You dip your fingers.
Deathly cold, then painful heat.
You flinch back, anxious.

In the water is a stone.

* * *

>look
craggy rocks, in the darkness
(DARK DESC)
1
2
Nothing lies behind.

Still water cools the air.
It seems to stretch forever.
No waves touch your feet.

A shining stone falls.
The water glows with pale light.
Ripples lap the shore.

>look
cracked rocks
Darkness on all sides.
Chill water lies at your feet.
Nothing lies behind.
jagged rocks
Darkness on all sides.
Chill water lies at your feet.
Nothing lies behind.

* * *

>look
craggy rocks, in the darkness
(DARK DESC)
1
2
Nothing lies behind.

Still water cools the air.
It seems to stretch forever.
No waves touch your feet.

A shining stone falls.
The water glows with pale light.
Ripples lap the shore.

>dive in
One breath, plus one held.
Even your bones feel like ice.
Darkness shrouds your thoughts.

upper pool, in dim light
The water is still.
 Shadows crowd in overhead.
 The silence deafens.

Before you, a stone.
It glows like a faint firefly.
Pale white, and fading.

The pale gleam recedes.
Inky dark cloaks the water.
The waves settle down.

It is now pitch dark in here!

* * *

Silent Stars
An Interactive Fiction by Zaq Grow
Release 1 / Serial number 130405 / Inform 7 build 6G60 (I6/v6.32 lib 6/12N) SD

craggy rocks, in the shadows
(DARK DESC)
1
2
Nothing lies behind.

Still water cools the air.
It seems to stretch forever.
No waves touch your feet.

>take stone
You plunge a hand in.
 It's like bare skin in deep space.
 Sensation departs.

 Struggling brings nothing.
 To reach it, you must dive in.
 Commit all, or none.

A shining stone falls.
The water glows with pale light.
Ripples lap the shore.

>i
You are carrying nothing.

>x stone
Ivory colored quartz.
Cloudy, like a summer day.
Warmer than skin heat.

* * *

>i
You are carrying nothing.

* * *

>take stone
You plunge a hand in.
 It's like bare skin in deep space.
 Sensation departs.

 Struggling brings nothing.
 To reach it, you must dive in.
 Commit all, or none.

A shining stone falls.
The water glows with pale light.
Ripples lap the shore.

>take stone
 Struggling brings nothing.
 To reach it, you must dive in.
 Commit all, or none.

The pale gleam recedes.
Inky dark cloaks the water.
The waves settle down.

>x water
You dip your fingers.
Deathly cold, then painful heat.
You flinch back, anxious.

In the water is a stone.

* * *

Silent Stars
An Interactive Fiction by Zaq Grow
Release 1 / Serial number 130405 / Inform 7 build 6G60 (I6/v6.32 lib 6/12N) SD

craggy rocks, in the shadows
(DARK DESC)
1
2
Nothing lies behind.

Still water cools the air.
It seems to stretch forever.
No waves touch your feet.

>dive in
One breath, plus one held.
Even your bones feel like ice.
Darkness shrouds your thoughts.

upper pool, in the shadows
(DARK DESC)
The water is still.
 Shadows crowd in overhead.
 The silence deafens.

Above, a stone falls.
The water glows with pale light.
Ripples lap the shore.

The water grows still.
 Shadows crowd in overhead.
 The silence deafens.

Before you, a stone.
It glows like a faint firefly.
Pale white, and fading.

>take stone
Taken.

The pale gleam recedes.
Inky dark cloaks the water.
The waves settle down.

>x stone
Admired at range,
the stone's glow waxes and wanes
like a  tiny moon.

It is now pitch dark in here!

>look
upper pool, in the shadows
The water is still.
 Shadows crowd in overhead.
 The silence deafens.

>dive
HAIKU HERE
lower pool, in dim light
The bottom is smooth.
 No signs of life scar the mud.
 Your guts feel frostbit.

Before you, a stone.
It glows like a faint firefly.
Pale white, and fading.

>i
You are carrying nothing.

* * *

>take stone
Taken.

The pale gleam recedes.
Inky dark cloaks the water.
The waves settle down.

>look
upper pool, in dim light
The water is still.
 Shadows crowd in overhead.
 The silence deafens.

>z
Time passes.

* * *

>dive in
One breath, plus one held.
Even your bones feel like ice.
Darkness shrouds your thoughts.

upper pool, in the shadows
(DARK DESC)
The water is still.
 Shadows crowd in overhead.
 The silence deafens.

Above, a stone falls.
The water glows with pale light.
Ripples lap the shore.

The water grows still.
 Shadows crowd in overhead.
 The silence deafens.

Before you, a stone.
It glows like a faint firefly.
Pale white, and fading.

>look
upper pool, in dim light
The water is still.
 Shadows crowd in overhead.
 The silence deafens.

Before you, a stone.
It glows like a faint firefly.
Pale white, and fading.

The pale gleam recedes.
Inky dark cloaks the water.
The waves settle down.

>d
lower pool, in dim light
The bottom is smooth.
 No signs of life scar the mud.
 Your guts feel frostbit.

Before you, a stone.
It glows like a faint firefly.
Pale white, and fading.

>take stone
Taken.

* * *

>dive in
One breath, plus one held.
Even your bones feel like ice.
Darkness shrouds your thoughts.

upper pool, in the shadows
(DARK DESC)
The water is still.
 Shadows crowd in overhead.
 The silence deafens.

Above, a stone falls.
The water glows with pale light.
Ripples lap the shore.

The water grows still.
 Shadows crowd in overhead.
 The silence deafens.

Before you, a stone.
It glows like a faint firefly.
Pale white, and fading.

>z
Time passes.

The pale gleam recedes.
Inky dark cloaks the water.
The waves settle down.

>take stone
You can't reach into the lower pool.

It is now pitch dark in here!

* * *

>z
Time passes.

The pale gleam recedes.
Inky dark cloaks the water.
The waves settle down.

>look
upper pool, in the gloom
The water is still.
 Shadows crowd in overhead.
 The silence deafens.

Down below, a stone.
It glows like a faint firefly.
Pale white, and fading.
It is now pitch dark in here!

* * *

Silent Stars
An Interactive Fiction by Zaq Grow
Release 1 / Serial number 130405 / Inform 7 build 6G60 (I6/v6.32 lib 6/12N) SD

craggy rocks, in the shadows
(DARK DESC)
1
2
Nothing lies behind.

Still water cools the air.
It seems to stretch forever.
No waves touch your feet.

>x down
You gaze downwards.

The water is still.
 Shadows close in overhead.
 Your hair drifts above.

>rules x down
I only understood you as far as wanting to rules.

>rules
Rules tracing now switched on. Type "rules off" to switch it off again, or "rules all" to include even rules which do not apply.

>x down
[Rule "After deciding the scope of the player while the location is in Dreamspace" applies.]
[Rule "standard examining rule" applies.]
[Rule "new examine directions rule" applies.]
Still water cools the air.
It seems to stretch forever.
No waves touch your feet.
[Rule "examine containers rule" applies.]
[Rule "examine supporters rule" applies.]
[Rule "examine devices rule" applies.]
[Rule "examine undescribed things rule" applies.]
You see nothing special about the down.

[Rule "report other people examining rule" applies.]
[Rule "determine visibility ceiling rule" applies.]
[Rule "room description heading rule" applies.]
a rocky shore line
[Rule "room description body text rule" applies.]
Darkness on all sides.
Chill water lies at your feet.
Nothing lies behind.

[Rule "room description paragraphs about objects rule" applies.]
[Rule "don't mention player's supporter in room descriptions rule" applies.]
[Rule "don't mention scenery in room descriptions rule" applies.]
[Rule "don't mention undescribed items in room descriptions rule" applies.]
[Rule "set pronouns from items in room descriptions rule" applies.]
[Rule "offer items to writing a paragraph about rule" applies.]
[Rule "use initial appearance in room descriptions rule" applies.]
[Rule "don't mention player's supporter in room descriptions rule" applies.]
[Rule "don't mention scenery in room descriptions rule" applies.]
[Rule "don't mention undescribed items in room descriptions rule" applies.]
[Rule "set pronouns from items in room descriptions rule" applies.]
[Rule "offer items to writing a paragraph about rule" applies.]
[Rule "use initial appearance in room descriptions rule" applies.]
[Rule "replacement arrival check rule" applies.]
[Rule "mark items as seen when looking rule" applies.]
[Rule "other people looking rule" applies.]

* * *

>x down
You gaze downwards.

The water is still.
 Shadows close in overhead.
 Your hair drifts above.

>x up
In nothing, stillness.
Fear and curiousity.
Turn lightward for now.

sharp rocks
Darkness on all sides.
Chill water lies at your feet.
Nothing lies behind.

* * *

Silent Stars
An Interactive Fiction by Zaq Grow
Release 1 / Serial number 130405 / Inform 7 build 6G60 (I6/v6.32 lib 6/12N) SD

craggy rocks, in the shadows
(DARK DESC)
1
2
Nothing lies behind.

Still water cools the air.
It seems to stretch forever.
No waves touch your feet.

>look down
Still water cools the air.
It seems to stretch forever.
No waves touch your feet.

>x down
Still water cools the air.
It seems to stretch forever.
No waves touch your feet.
a rocky shore line
Darkness on all sides.
Chill water lies at your feet.
Nothing lies behind.

* * *

Silent Stars
An Interactive Fiction by Zaq Grow
Release 1 / Serial number 130405 / Inform 7 build 6G60 (I6/v6.32 lib 6/12N) SD

craggy rocks, in the shadows
(DARK DESC)
1
2
Nothing lies behind.

Still water cools the air.
It seems to stretch forever.
No waves touch your feet.

>actions
Actions listing on.

>x water
You can't see any such thing.

>look down
[examining down]
Still water cools the air.
It seems to stretch forever.
No waves touch your feet.
[examining down - succeeded]

>x down
[examining down]
Still water cools the air.
It seems to stretch forever.
No waves touch your feet.
[examining down - succeeded]

[looking]
a rocky shore line
Darkness on all sides.
Chill water lies at your feet.
Nothing lies behind.

[looking - succeeded]

* * *

>actions
Actions listing on.

>rules
Rules tracing now switched on. Type "rules off" to switch it off again, or "rules all" to include even rules which do not apply.

>z
[waiting]
[Rule "standard report waiting rule" applies.]
Time passes.
[waiting - succeeded]

>z
[waiting]
[Rule "standard report waiting rule" applies.]
Time passes.
[waiting - succeeded]

[Rule "determine visibility ceiling rule" applies.]
[looking]
[Rule "room description heading rule" applies.]
cracked rocks
[Rule "room description body text rule" applies.]
Darkness on all sides.
Chill water lies at your feet.
Nothing lies behind.

[Rule "room description paragraphs about objects rule" applies.]
[Rule "don't mention player's supporter in room descriptions rule" applies.]
[Rule "don't mention scenery in room descriptions rule" applies.]
[Rule "don't mention undescribed items in room descriptions rule" applies.]
[Rule "set pronouns from items in room descriptions rule" applies.]
[Rule "offer items to writing a paragraph about rule" applies.]
[Rule "use initial appearance in room descriptions rule" applies.]
[Rule "don't mention player's supporter in room descriptions rule" applies.]
[Rule "don't mention scenery in room descriptions rule" applies.]
[Rule "don't mention undescribed items in room descriptions rule" applies.]
[Rule "set pronouns from items in room descriptions rule" applies.]
[Rule "offer items to writing a paragraph about rule" applies.]
[Rule "use initial appearance in room descriptions rule" applies.]
[Rule "replacement arrival check rule" applies.]
[Rule "mark items as seen when looking rule" applies.]
[Rule "other people looking rule" applies.]
[looking - succeeded]

* * *

>actions
Actions listing on.

>z
[waiting]
Time passes.
[waiting - succeeded]

>z
[waiting]
Time passes.
[waiting - succeeded]

[looking]
sharp rocks
Darkness on all sides.
Chill water lies at your feet.
Nothing lies behind.

[looking - succeeded]

>scenes
Scene 'Entire Game' playing (for 2 mins now)
Scene 'Autodoc Escape' playing (for 2 mins now)
(Scene monitoring now switched on. Type "scenes off" to switch it off again.)

* * *

>actions
Actions listing on.

>look
[looking]
gravelly rocks
Darkness on all sides.
Chill water lies at your feet.
Nothing lies behind.
[looking - succeeded]

>look
[looking]
jagged rocks
Darkness on all sides.
Chill water lies at your feet.
Nothing lies behind.
[looking - succeeded]

[looking]
cracked rocks
Darkness on all sides.
Chill water lies at your feet.
Nothing lies behind.

[looking - succeeded]

* * *

Silent Stars
An Interactive Fiction by Zaq Grow
Release 1 / Serial number 130405 / Inform 7 build 6G60 (I6/v6.32 lib 6/12N) SD

craggy rocks, in the shadows
(DARK DESC)
1
2
Nothing lies behind.

Still water cools the air.
It seems to stretch forever.
No waves touch your feet.

>x darkness
You can't see any such thing.

>x water
You can't see any such thing.

* * *

Silent Stars
An Interactive Fiction by Zaq Grow
Release 1 / Serial number 130405 / Inform 7 build 6G60 (I6/v6.32 lib 6/12N) SD

craggy rocks, in the shadows
(DARK DESC)
1
2
Nothing lies behind.

Still water cools the air.
It seems to stretch forever.
No waves touch your feet.

>showme water
water - backdrop
location: out of play
singular-named, improper-named; unlit, inedible, fixed in place, scenery, neuter, ordinarily enumerated, unseen, unfamiliar, mundane, unexamined, cold, dim, diffuse
printed name: "water"
printed plural name: "backdrops"
indefinite article: none
description: "You dip your fingers.
Deathly cold, then painful heat.
You flinch back, anxious.

Down below, a stone.
It glows like a faint firefly.
Pale white, and fading."
initial appearance: none
bulk: 1
dark-description: "The water has no description in the dark."
sound: "silence"
sound-description: "This does not make noise."

* * *

Silent Stars
An Interactive Fiction by Zaq Grow
Release 1 / Serial number 130405 / Inform 7 build 6G60 (I6/v6.32 lib 6/12N) SD

craggy rocks, in the shadows
(DARK DESC)
1
2
Nothing lies behind.

Still water cools the air.
It seems to stretch forever.
No waves touch your feet.

>d
upper pool, in the darkness
The upper pool has no description in the dark.

>z
Time passes.

upper pool
The water is still.
 Shadows crowd in overhead.
 The silence deafens.

>z
Time passes.

* * *

>d
upper pool, in the darkness
The upper pool has no description in the dark.

I beg your pardon?

>d
lower pool
The bottom is smooth.
 No signs of life scar the mud.
 Your guts feel frostbit.

Down below, a stone.
It glows like a faint firefly.
Pale white, and fading.

>z
Time passes.

* * *

>d
upper pool, in the darkness
The upper pool has no description in the dark.

>u
craggy rocks, in the shadows
Darkness on all sides.
Chill water lies at your feet.
Nothing lies behind.

>x stone
Admired at range,
the stone's glow waxes and wanes
like a  tiny moon.

* * *

Silent Stars
An Interactive Fiction by Zaq Grow
Release 1 / Serial number 130405 / Inform 7 build 6G60 (I6/v6.32 lib 6/12N) SD

craggy rocks, in the shadows
(DARK DESC)
1
2
Nothing lies behind.

Still water cools the air.
It seems to stretch forever.
No waves touch your feet.

>lumos
{{The light level in the gravelly rocks qualifies for: dark}}
{{Light-bearing things: nothing}}

>z
Time passes.

craggy rocks, in dim light
Darkness on all sides.
Chill water lies at your feet.
Nothing lies behind.

>lumos
{{The light level in the jagged rocks qualifies for: }}
{{Light-bearing things: nothing}}

>d
upper pool, in the gloom
The upper pool has no description in the dark.

>z
Time passes.

upper pool, in dim light
The water is still.
 Shadows crowd in overhead.
 The silence deafens.

>lumos
{{The light level in the upper pool qualifies for: }}
{{Light-bearing things: nothing}}

* * *

>lumos
{{The light level in the jagged rocks qualifies for: }}
{{Light-bearing things: nothing}}

>z
Time passes.

>d
upper pool, in the gloom
The upper pool has no description in the dark.

>lumos
{{The light level in the upper pool qualifies for: }}
{{Light-bearing things: nothing}}

upper pool, in dim light
The water is still.
 Shadows crowd in overhead.
 The silence deafens.

>lumos
{{The light level in the upper pool qualifies for: }}
{{Light-bearing things: nothing}}

>d
lower pool, in the shadows
The bottom is smooth.
 No signs of life scar the mud.
 Your guts feel frostbit.

Down below, a stone.
It glows like a faint firefly.
Pale white, and fading.

>u
upper pool, in dim light
The water is still.
 Shadows crowd in overhead.
 The silence deafens.

>look down
You gaze downwards.

The bottom is smooth.
 No signs of life scar the mud.
 Your guts feel frostbit.

>d
lower pool, in dim light
The bottom is smooth.
 No signs of life scar the mud.
 Your guts feel frostbit.

Down below, a stone.
It glows like a faint firefly.
Pale white, and fading.

>take stone
Taken.

>i
You are carrying:
  a stone (providing light)

* * *

>lumos
{{The light level in the gravelly rocks qualifies for: dark}}
{{Light-bearing things: nothing}}

>x nothing
In nothing, stillness.
Fear and curiousity.
Turn lightward for now.

jagged rocks, in dim light
Darkness on all sides.
Chill water lies at your feet.
Nothing lies behind.

>lumos
{{The light level in the cracked rocks qualifies for: }}
{{Light-bearing things: nothing}}

* * *

Silent Stars
An Interactive Fiction by Zaq Grow
Release 1 / Serial number 130405 / Inform 7 build 6G60 (I6/v6.32 lib 6/12N) SD

craggy rocks, in the shadows
(DARK DESC)
1
2
Nothing lies behind.

Still water cools the air.
It seems to stretch forever.
No waves touch your feet.

>take all
There are none at all available!

>take stone
You plunge a hand in.
 It's like bare skin in deep space.
 Sensation departs.

 Struggling brings nothing.
 To reach it, you must dive in.
 Commit all, or none.

That isn't available.

A shining stone falls.
The water glows with pale light.
Ripples lap the shore.

* * *

Silent Stars
An Interactive Fiction by Zaq Grow
Release 1 / Serial number 130405 / Inform 7 build 6G60 (I6/v6.32 lib 6/12N) SD

craggy rocks, in the shadows
(DARK DESC)
1
2
Nothing lies behind.

Still water cools the air.
It seems to stretch forever.
No waves touch your feet.

>dive
I didn't understand that sentence.

>x nothing
In nothing, stillness.
Fear and curiousity.
Turn lightward for now.

A shining stone falls.
The water glows with pale light.
Ripples lap the shore.

>dive in
upper pool, in dim light
The water is still.
 Shadows crowd in overhead.
 The silence deafens.

Down below, a stone.
It glows like a faint firefly.
Pale white, and fading.

HAIKU HERE
The pale gleam recedes.
Inky dark cloaks the water.
The waves settle down.

It is now pitch dark in here!

* * *

Silent Stars
An Interactive Fiction by Zaq Grow
Release 1 / Serial number 130405 / Inform 7 build 6G60 (I6/v6.32 lib 6/12N) SD

craggy rocks, in the shadows
(DARK DESC)
1
2
Nothing lies behind.

Still water cools the air.
It seems to stretch forever.
No waves touch your feet.

>scenes
Scene 'Entire Game' playing (for 0 mins now)
Scene 'Dreamtime' playing (for 0 mins now)
(Scene monitoring now switched on. Type "scenes off" to switch it off again.)

>dive in
One breath, plus one held.

Even your bones feel like ice.

Darkness shrouds your thoughts.

upper pool, in the shadows
(DARK DESC)
The water is still.
 Shadows crowd in overhead.
 The silence deafens.

Above, a stone falls.
The water glows with pale light.
Ripples lap the shore.

upper pool, in dim light
The water is still.
 Shadows crowd in overhead.
 The silence deafens.

Before you, a stone.
It glows like a faint firefly.
Pale white, and fading.

>take stone
Taken.

[Scene 'Dreamtime' ends]