The smell of burning electronics hits your lizard hindbrain like a rivet gun and you awaken almost immediately, limbs flailing against the sides of the coffin. A badly-milled bolt opens a bloody streak on the back of your wrist, and several seconds pass before you realize you can't feel it because you're completely numb.
 ...
 The smoke smell drifts by your nose again, a little stronger. You startle and bark your forehead on the plastex window above you. The pain keeps you awake this time.

Silent Stars
An Interactive Fiction by Zaq Grow
Release 1 / Serial number 130328 / Inform 7 build 6G60 (I6/v6.32 lib 6/12N) SD

Kitchen
Silk curtains, dark wood cabinets, matte grey hardware: you're in the kitchen of your family home. No matter how much time you spend in your workshop or the little office in the hut out back, this is where you truly feel you're at rest.

Thin handwoven silk curtains shroud a couple of blurred shapes moving around the yard outside.

A gas range, showpiece of the kitchen and the center of your food obsessions, claims center stage in the middle of the kitchen island. A bright red teapot rests on the stove. The flame under the burner is lit.

Table of Max Actions goes here.

>press cycle
The button changes to green and blinks "Completed" a couple times.

* * *

>out
Medical Bay, in the darkness
The Medical Bay has no description in the dark.

>look
Medical Bay, in the gloom
The Medical Bay has no description in the dark.

>x radio
You can't see any such thing.

>listen
radio emits an unbroken stream of static.

>x radio
You can't see any such thing.

>look
Medical Bay, in the gloom
The Medical Bay has no description in the dark.

>turn on sunrod
LIGHTS
You switch the srnoud on.

Mdcieal Bay
The Medical Bay: filled with all the pointy and invasive tools of the trade.

A dark plastex porthole is set into the hatch of the autodoc.

This is the init app of the radio. It emits a constant stream of static.

You can also see a Miedacl htcah and a wedigt here.

* * *

>out
Medical Bay, in the darkness
The Medical Bay has no description in the dark.

>turn on sunrod
LIGHTS
You switch the suonrd on.

Macdeil yaB
The Medical Bay: filled with all the pointy and invasive tools of the trade.

A dark plastex porthole is set into the hatch of the autodoc.

This is the init app of the radio. It emits a constant stream of static.

You can also see a Meicdal hatch and a widget here.

* * *

>press exit
A beat passes, and then the gasket on the autodoc's hatch disengages with a whoosh of pressurized air. The stench of old blood quickly replaces the tang of disinfectants.

You open the htcah.

>rules
Rules tracing now switched on. Type "rules off" to switch it off again, or "rules all" to include even rules which do not apply.

>out
[Rule "Setting action variables for exiting" applies.]
[Rule "convert exit into go out rule" applies.]
[Rule "standard set going variables rule" applies.]
[Rule "can't travel in what's not a vehicle rule" applies.]
[Rule "can't go through undescribed doors rule" applies.]
[Rule "can't go through closed doors rule" applies.]
[Rule "determine map connection rule" applies.]
[Rule "can't go that way rule" applies.]
[Rule "move player and vehicle rule" applies.]
[Rule "move floating objects rule" applies.]
[Rule "check light in new location rule" applies.]
[Rule "describe room gone into rule" applies.]

[Rule "determine visibility ceiling rule" applies.]
[Rule "room description heading rule" applies.]
[Rule "new room-name rule" applies.]
Medical Bay, in the shadows
[Rule "room description body text rule" applies.]
The Medical Bay has no description in the dark.
[Rule "room description paragraphs about objects rule" applies.]
[Rule "replacement arrival check rule" applies.]
[Rule "mark items as seen when looking rule" applies.]
[Rule "other people looking rule" applies.]

* * *

>rules
Rules tracing now switched on. Type "rules off" to switch it off again, or "rules all" to include even rules which do not apply.

>rules off
Rules tracing now switched off. Type "rules" to switch it on again.

>pres scycle
That's not a verb I recognise.

>press cycle
The button changes to green and blinks "Completed" a couple times.

* * *

>press unlock
The "Unlock Hatch" button changes to green.

>press exit
A beat passes, and then the gasket on the autodoc's hatch disengages with a whoosh of pressurized air. The stench of old blood quickly replaces the tang of disinfectants.

You open the hctah.

>rules all
Rules tracing now switched to "all". Type "rules off" to switch it off again.

>out
[Rule "standard set going variables rule" does not apply.]
[Rule "determine visibility ceiling rule" does not apply.]
[Rule "Setting action variables for exiting" applies.]
[Rule "Before going through a closed hatch ( called the blocking hatch )" does not apply.]
[Rule "Before opening the Autodoc's hatch" does not apply.]
[Rule "Instead of pushing the cycle button" does not apply.]
[Rule "Instead of pushing the unlock button" does not apply.]
[Rule "Instead of pushing the exit button" does not apply.]
[Rule "Instead of pushing a button ( called the frobber )" does not apply.]
[Rule "convert exit into go out rule" applies.]
[Rule "standard set going variables rule" applies.]
[Rule "determine visibility ceiling rule" does not apply.]
[Rule "Setting action variables for exiting" does not apply.]
[Rule "Before going through a closed hatch ( called the blocking hatch )" does not apply.]
[Rule "Before opening the Autodoc's hatch" does not apply.]
[Rule "Instead of pushing the cycle button" does not apply.]
[Rule "Instead of pushing the unlock button" does not apply.]
[Rule "Instead of pushing the exit button" does not apply.]
[Rule "Instead of pushing a button ( called the frobber )" does not apply.]
[Rule "stand up before going rule" does not apply.]
[Rule "can't travel in what's not a vehicle rule" applies.]
[Rule "can't go through undescribed doors rule" applies.]
[Rule "can't go through closed doors rule" applies.]
[Rule "determine map connection rule" applies.]
[Rule "can't go that way rule" applies.]
[Rule "move player and vehicle rule" applies.]
[Rule "move floating objects rule" applies.]
[Rule "check light in new location rule" applies.]
[Rule "describe room gone into rule" applies.]

[Rule "standard set going variables rule" does not apply.]
[Rule "determine visibility ceiling rule" applies.]
[Rule "Setting action variables for exiting" does not apply.]
[Rule "room description heading rule" applies.]
[Rule "new room-name rule" applies.]
Medical Bay, in the gloom
[Rule "room description body text rule" applies.]
The Medical Bay has no description in the dark.
[Rule "room description paragraphs about objects rule" applies.]
[Rule "replacement arrival check rule" applies.]
[Rule "mark items as seen when looking rule" applies.]
[Rule "other people looking rule" applies.]

* * *

>press exit
A beat passes, and then the gasket on the autodoc's hatch disengages with a whoosh of pressurized air. The stench of old blood quickly replaces the tang of disinfectants.

You open the hctah.

>rules
Rules tracing now switched on. Type "rules off" to switch it off again, or "rules all" to include even rules which do not apply.

* * *

>look
Kitchen
Silk curtains, dark wood cabinets, matte grey hardware: you're in the kitchen of your family home. No matter how much time you spend in your workshop or the little office in the hut out back, this is where you truly feel you're at rest.

Thin handwoven silk curtains shroud a couple of blurred shapes moving around the yard outside.

A gas range, showpiece of the kitchen and the center of your food obsessions, claims center stage in the middle of the kitchen island. A bright red teapot rests on the stove. The flame under the burner is lit.

Table of Max Actions goes here.

12:00 am

>exit
The control panel flashes red and beeps. It seems the hatch is locked shut.

* * *

>look
Kitchen
Silk curtains, dark wood cabinets, matte grey hardware: you're in the kitchen of your family home. No matter how much time you spend in your workshop or the little office in the hut out back, this is where you truly feel you're at rest.

Thin handwoven silk curtains shroud a couple of blurred shapes moving around the yard outside.

A gas range, showpiece of the kitchen and the center of your food obsessions, claims center stage in the middle of the kitchen island. A bright red teapot rests on the stove. The flame under the burner is lit.

Table of Max Actions goes here.

12:00 am

>look
Kitchen
Silk curtains, dark wood cabinets, matte grey hardware: you're in the kitchen of your family home. No matter how much time you spend in your workshop or the little office in the hut out back, this is where you truly feel you're at rest.

Thin handwoven silk curtains shroud a couple of blurred shapes moving around the yard outside.

A gas range, showpiece of the kitchen and the center of your food obsessions, claims center stage in the middle of the kitchen island. A bright red teapot rests on the stove. The flame under the burner is lit.

Table of Max Actions goes here.

12:01 am

>look
Kitchen, in dim light
Silk curtains, dark wood cabinets, matte grey hardware: you're in the kitchen of your family home. No matter how much time you spend in your workshop or the little office in the hut out back, this is where you truly feel you're at rest.

Thin handwoven silk curtains shroud a couple of blurred shapes moving around the yard outside.

{{The light level in here qualifies for: bright dim .}}

>look
Kitchen, in dim light
Silk curtains, dark wood cabinets, matte grey hardware: you're in the kitchen of your family home. No matter how much time you spend in your workshop or the little office in the hut out back, this is where you truly feel you're at rest.

Thin handwoven silk curtains shroud a couple of blurred shapes moving around the yard outside.

{{The light level in here is bright!}}

* * *

>look
Kitchen
Silk curtains, dark wood cabinets, matte grey hardware: you're in the kitchen of your family home. No matter how much time you spend in your workshop or the little office in the hut out back, this is where you truly feel you're at rest.

Thin handwoven silk curtains shroud a couple of blurred shapes moving around the yard outside.

A gas range, showpiece of the kitchen and the center of your food obsessions, claims center stage in the middle of the kitchen island. A bright red teapot rests on the stove. The flame under the burner is lit.

Table of Max Actions goes here.

12:00 am

>z
Time passes.

{{The light level in here qualifies for: bright dim .}}

>z
Time passes.

{{The light level in here qualifies for: bright dim .}}

* * *

>x panel
The edges of the control panel have some biogunk in them.

* * *

>open curtain
You open the curtain, revealing a window.

>x window
Outside, you can see your son Victor playing in the garden with the neighbor boy. They're pretending to be soldiers, creeping around and through the plants on belly and forearms, evading imaginary machine-gun fire. Maxie hates this game, says it'll make Victor too aggressive when he's older, but you never chastise Victor for it: anything to get him to play outside.

>x curtain
In the curtain is a window.

>look
Kitchen, in dim light
Woven silk curtains, dark wood cabinets, matte grey hardware: you're in the kitchen of your family home. No matter how much time you spent in your workshop or the little office in the hut out back, this is where you truly feel you're at rest.

A pair of smart woven silk curtains frame the kitchen window; in the yard outside, Victor and his friend play at being soldiers.

>close curtain
You close the curtain.

>x window
You can't see any such thing.

* * *

>open curtain
You open the curtain, revealing a window.

>close curtain
You close the curtain.

>x curtain
You see nothing special about the curtain.

* * *

>x right hand
The bolt on the coffin wall tore a jagged scratch across the back of your right hand. It doesn't seem to affect your ability to use the hand, which is good, but it hurts like crazy and refuses to stop trickling blood, which is bad. !!{if bandaged}A thick white bandage is wound around your hand like a prizefighter's wrist wrap. The gauze pad on the back !!has bled through/has not bled through/etc.

>x left hand
It's your left hand. {if brightness of location is black}You flex it once or twice to make sure it's still there{otherwise}Missing fingertip on middle finger (bar fight), blank pinky fingerprint (close call with industrial acid), inoculation and transit scars on the back (expensive counterfeits){end if}.

* * *

>x window
You open the curtains, tying them back with the little cord so they hang neatly.

Outside, you can see your son Victor playing in the garden with the neighbor boy. They're pretending to be soldiers, creeping around and through the plants on belly and forearms, evading imaginary machine-gun fire. Maxie hates this game, says it'll make Victor too aggressive when he's older, but you never chastise Victor for it. Anything to get him to play outside.

>look
Kitchen, in dim light
Silk curtains, dark wood cabinets, matte grey hardware: you're in the kitchen of your family home. No matter how much time you spend in your workshop or the little office in the hut out back, this is where you truly feel you're at rest.

A pair of smart woven silk curtains frame the kitchen window; in the yard outside, Victor and his friend play at being soldiers.

>lumos
Kitchen is bright.

>look
Kitchen, in dim light
Silk curtains, dark wood cabinets, matte grey hardware: you're in the kitchen of your family home. No matter how much time you spend in your workshop or the little office in the hut out back, this is where you truly feel you're at rest.

A pair of smart woven silk curtains frame the kitchen window; in the yard outside, Victor and his friend play at being soldiers.

>rules
Rules tracing now switched on. Type "rules off" to switch it off again, or "rules all" to include even rules which do not apply.

>turn on sunrod
[Rule "can't switch on unless switchable rule" applies.]
[Rule "can't switch on what's already on rule" applies.]
[Rule "Carry out switching on the sunrod" applies.]
LIGHTS
[Rule "standard switching on rule" applies.]
[Rule "standard report switching on rule" applies.]
You switch the sunrod on.

>look
[Rule "determine visibility ceiling rule" applies.]
[Rule "room description heading rule" applies.]
Kitchen, in dim light
[Rule "room description body text rule" applies.]
Silk curtains, dark wood cabinets, matte grey hardware: you're in the kitchen of your family home. No matter how much time you spend in your workshop or the little office in the hut out back, this is where you truly feel you're at rest.

[Rule "room description paragraphs about objects rule" applies.]
[Rule "don't mention player's supporter in room descriptions rule" applies.]
[Rule "don't mention scenery in room descriptions rule" applies.]
[Rule "don't mention undescribed items in room descriptions rule" applies.]
[Rule "set pronouns from items in room descriptions rule" applies.]
[Rule "offer items to writing a paragraph about rule" applies.]
[Rule "use initial appearance in room descriptions rule" applies.]
[Rule "describe what's on scenery supporters in room descriptions rule" applies.]
[Rule "don't mention player's supporter in room descriptions rule" applies.]
[Rule "don't mention scenery in room descriptions rule" applies.]
[Rule "don't mention undescribed items in room descriptions rule" applies.]
[Rule "set pronouns from items in room descriptions rule" applies.]
[Rule "offer items to writing a paragraph about rule" applies.]
[Rule "use initial appearance in room descriptions rule" applies.]
A pair of smart woven silk curtains frame the kitchen window; in the yard outside, Victor and his friend play at being soldiers.

[Rule "describe what's on scenery supporters in room descriptions rule" applies.]
[Rule "replacement arrival check rule" applies.]
[Rule "mark items as seen when looking rule" applies.]
[Rule "other people looking rule" applies.]

>lumos
[Rule "Report current-light-level" applies.]
Kitchen is bright.

>turn off sunrod
[Rule "can't switch off unless switchable rule" applies.]
[Rule "can't switch off what's already off rule" applies.]
[Rule "Carry out switching off the sunrod" applies.]
DARKNESS
[Rule "standard switching off rule" applies.]
[Rule "standard report switching off rule" applies.]
You switch the sunrod off.

>look
[Rule "determine visibility ceiling rule" applies.]
[Rule "room description heading rule" applies.]
Kitchen, in dim light
[Rule "room description body text rule" applies.]
Silk curtains, dark wood cabinets, matte grey hardware: you're in the kitchen of your family home. No matter how much time you spend in your workshop or the little office in the hut out back, this is where you truly feel you're at rest.

[Rule "room description paragraphs about objects rule" applies.]
[Rule "don't mention player's supporter in room descriptions rule" applies.]
[Rule "don't mention scenery in room descriptions rule" applies.]
[Rule "don't mention undescribed items in room descriptions rule" applies.]
[Rule "set pronouns from items in room descriptions rule" applies.]
[Rule "offer items to writing a paragraph about rule" applies.]
[Rule "use initial appearance in room descriptions rule" applies.]
[Rule "describe what's on scenery supporters in room descriptions rule" applies.]
[Rule "don't mention player's supporter in room descriptions rule" applies.]
[Rule "don't mention scenery in room descriptions rule" applies.]
[Rule "don't mention undescribed items in room descriptions rule" applies.]
[Rule "set pronouns from items in room descriptions rule" applies.]
[Rule "offer items to writing a paragraph about rule" applies.]
[Rule "use initial appearance in room descriptions rule" applies.]
A pair of smart woven silk curtains frame the kitchen window; in the yard outside, Victor and his friend play at being soldiers.

[Rule "describe what's on scenery supporters in room descriptions rule" applies.]
[Rule "replacement arrival check rule" applies.]
[Rule "mark items as seen when looking rule" applies.]
[Rule "other people looking rule" applies.]

>rules off
Rules tracing now switched off. Type "rules" to switch it on again.

>showme kitchen
Kitchen - room
    yourself - person
        left hand (part of yourself)
        right hand (part of yourself)
        sunrod - device
    curtains - transparent open container
        window
singular-named, proper-named; lighted, visited
printed name: "Kitchen"
printed plural name: none
indefinite article: none
description: "Silk curtains, dark wood cabinets, matte grey hardware: you're in the kitchen of your family home. No matter how much time you spend in your workshop or the little office in the hut out back, this is where you truly feel you're at rest."
dark-description: "The Kitchen has no description in the dark."
sound: "silence"
sound-description: "Total silence."

* * *

>x window
You open the curtains, tying them back with the little cord so they hang neatly.

Outside, you can see your son Victor playing in the garden with the neighbor boy. They're pretending to be soldiers, creeping around and through the plants on belly and forearms, evading imaginary machine-gun fire. Maxie hates this game, says it'll make Victor too aggressive when he's older, but you never chastise Victor for it. Anything to get him to play outside.

>rules
Rules tracing now switched on. Type "rules off" to switch it off again, or "rules all" to include even rules which do not apply.

* * *

>actions
Actions listing on.

>close curtains
[closing the curtains]
[Rule "can't close unless openable rule" applies.]
[Rule "can't close what's already closed rule" applies.]
[Rule "standard closing rule" applies.]
[Rule "standard report closing rule" applies.]
You close the curtains.
[closing the curtains - succeeded]

>close curtain
You can't see any such thing.

>x window
[examining the window]
[Rule "Before examining the window while the curtains are closed" applies.]
[(1) opening the curtains]
[Rule "can't open unless openable rule" applies.]
[Rule "can't open what's locked rule" applies.]
[Rule "can't open what's already open rule" applies.]
[Rule "standard opening rule" applies.]
[Rule "mark items as seen on opening a container rule" applies.]
[Rule "Report opening the curtains" applies.]
You open the curtains, tying them back with the little cord so they hang neatly.

[Rule "reveal any newly visible interior rule" applies.]
[Rule "standard report opening rule" applies.]
You open the curtains.
[(1) opening the curtains - succeeded]

[Rule "mark items as seen on examining rule" applies.]
[Rule "standard examining rule" applies.]
Outside, you can see your son Victor playing in the garden with the neighbor boy. They're pretending to be soldiers, creeping around and through the plants on belly and forearms, evading imaginary machine-gun fire. Maxie hates this game, says it'll make Victor too aggressive when he's older, but you never chastise Victor for it. Anything to get him to play outside.

[Rule "examine directions rule" applies.]
[Rule "examine containers rule" applies.]
[Rule "examine supporters rule" applies.]
[Rule "examine devices rule" applies.]
[Rule "examine undescribed things rule" applies.]
[Rule "report other people examining rule" applies.]
[examining the window - succeeded]

* * *

>lumos
{{The light level in the Kitchen qualifies for: bright dim }}
{{Light-bearing things: window}}

{{The light level in the Kitchen qualifies for: bright dim }}

* * *

>z
Time passes.

{{The light level in the Kitchen qualifies for: bright }}

* * *

>gonear autodoc
Antiseptic Coffin, in the gloom
You're lying down inside a metal coffin that isn't much larger than you. It (you?) reeks of medical disinfectants; the fuzziness in your head feels like it's keeping away a headache from all the fumes.

A small plastex window is set into the hatch above you.

The control panel above you shows a blinking red button.

* * *

>x cabinets
The cabinets were Maxie's choice: maple, stained in a dark rocky brown, with sterling silver hardware. Not your first choice, but now you can't imagine a kitchen without them. Max always was better at color coordination.

* * *

>open cabinet
You reach up to open the closest cupboard, but stop halfway. You can't remember what you needed out of the cabinets in the first place.

* * *

>turn off stove
That's already off.

>turn on stove
You switch the gas stove on.

>turn off stove
You switch the gas stove off.

* * *

>switch off stove
You switch the knob off.

* * *

>x stove
It's a gas range, installed at great expense and peril. Being part of the Engineer's Scholarship affords certain benefits and special privileges; one must take advantage of them when one can.

>showme burner
burner - supporter
    red teapot
location: part of the gas stove in Kitchen
singular-named, improper-named; unlit, inedible, fixed in place, neuter, ordinarily enumerated, seen, unfamiliar, mundane, unexamined, dim, diffuse; printed name: "burner"
printed plural name: "supporters"
indefinite article: none
description: none
initial appearance: "You always liked the blue hue of those flames."
bulk: 1
dark-description: "The burner has no description in the dark."
sound: "silence"
sound-description: "This does not make noise."
carrying capacity: 100

>showme teapot
red teapot - thing
location: on the burner , which is part of the gas stove in Kitchen
singular-named, improper-named; unlit, inedible, portable, neuter, ordinarily enumerated, seen, unfamiliar, mundane, unexamined, dim, diffuse
printed name: "red teapot"
printed plural name: none
indefinite article: none
description: "A cherry-red teapot, shaped like a sphere of jello resting on a plate. Not the ugliest appliance in here, but definitely not the prettiest."
initial appearance: "The last little bit of hot water in the teapot is still warm enough to let off some steam."
bulk: 1
dark-description: "The red teapot has no description in the dark."
sound: "whistling"
sound-description: "A thin, high keening whistle, much more shrill than a train engine. It's loud enough to throb in your ear, not quite painful."

* * *

>take teapot
Can't brew coffee with cold water. That is, not if you want to drink it the same day.

>x burner
On the burner is a red teapot.

* * *

>x burner
You always liked the blue hue of those flames.

On the burner is a red teapot.

>x flame
You always liked the blue hue of those flames.

On the burner is a red teapot.

>turn off stove
That's already off.

>turn on stove
The igniter ticks a few times and the flame catches with a quiet huff of combustion.

You switch the gas stove on.