The smell of burning electronics hits your lizard hindbrain like a rivet gun and you awaken almost immediately, limbs flailing against the sides of the coffin. A badly-milled bolt opens a bloody streak on the back of your wrist, and several seconds pass before you realize you can't feel it because you're completely numb.
 ...
 The smoke smell drifts by your nose again, a little stronger. You startle and bark your forehead on the plastex window above you. The pain keeps you awake this time.

Silent Stars
An Interactive Fiction by Zaq Grow
Release 1 / Serial number 130321 / Inform 7 build 6G60 (I6/v6.32 lib 6/12N) SD

Antiseptic Coffin, in the shadows
You're lying down inside a metal coffin that isn't much larger than you. It (you?) reeks of medical disinfectants; the fuzziness in your head feels like it's keeping away a headache from all the fumes.

A small plastex window is set into the hatch above you.

The control panel above you shows a blinking red button.

>press cycle
The button changes to green and blinks "Completed" a couple times.

* * *

>press unlock
The "Unlock Hatch" button changes to green.

>press exit
A beat passes, and then the gasket on the autodoc's hatch disengages with a whoosh of pressurized air. The stench of old blood quickly replaces the tang of disinfectants.

You open the hatch.

>out
Medical Bay, in the shadows
The Medical Bay has no description in the dark.

>search widget
You can't see any such thing.

* * *

>out
Medical Bay, in the shadows
The Medical Bay has no description in the dark.

>look
The Medical Bay has no description in the dark.

>x widget
It is pitch dark, and you can't see a thing.

>take widget
Taken.

>x widget
It is pitch dark, and you can't see a thing.

>x sunrod
It is pitch dark, and you can't see a thing.

>turn on sunrod
LIGHTS
You switch the sunrod on.

Medical Bay, in the shadows
The Medical Bay: filled with all the pointy and invasive tools of the trade.

A dark plastex porthole is set into the hatch of the autodoc.

You can also see a Medical hatch here.

>x widget
You see nothing special about the widget.

>x sunrod
The sunrod is currently switched on.

* * *

>lambency
The Antiseptic Coffin is dim.

>showme coffin
Antiseptic Coffin - room
    hatch - hatch
        hatch window (part of hatch)
    yourself - person
        left hand (part of yourself)
        right hand (part of yourself)
        sunrod - device
    control panel - panel
        cycle button (part of control panel) - button
        unlock button (part of control panel) - button
        exit button (part of control panel) - button
singular-named, improper-named; lighted, visited
printed name: "Antiseptic Coffin"
printed plural name: none
indefinite article: none
description: "You're lying down inside a metal coffin that isn't much larger than you. It (you?) reeks of medical disinfectants; the fuzziness in your head feels like it's keeping away a headache from all the fumes."
map region: Deck A
dark-description: "It's cold and damp and dark in here."

>look
Antiseptic Coffin, in dim light
You're lying down inside a metal coffin that isn't much larger than you. It (you?) reeks of medical disinfectants; the fuzziness in your head feels like it's keeping away a headache from all the fumes.

A small plastex window is set into the hatch above you.

The control panel above you shows a blinking red button.

* * *

>rules all
Rules tracing now switched to "all". Type "rules off" to switch it off again.

>listen
[Rule "ambient odour rule" does not apply.]
[Rule "ambient sound rule" applies.]
[Rule "standard set going variables rule" does not apply.]
[Rule "determine visibility ceiling rule" does not apply.]
[Rule "Setting action variables for exiting" does not apply.]
[Rule "Before going through a closed hatch ( called the blocking hatch )" does not apply.]
[Rule "Before opening the Autodoc's hatch" does not apply.]
[Rule "Instead of pushing the cycle button" does not apply.]
[Rule "Instead of pushing the unlock button" does not apply.]
[Rule "Instead of pushing the exit button" does not apply.]
[Rule "Instead of pushing a button ( called the frobber )" does not apply.]
[Rule "block listening rule" applies.]
You hear nothing unexpected.

* * *

>listen to window and panel
You can't use multiple objects with that verb.

>listen to window
You tap the hatch window on a nearby bulkhead, to no effect.

* * *

>listen to window
You hear nothing from the hatch window.

* * *

>listen
Total silence.

>listen to radio
The radio emits an unbroken stream of static.

* * *

>listen to radio
The radio emits an unbroken stream of static.

>listen to radio
The radio emits an unbroken stream of static.

* * *

>listen to radio and panel
radio: The radio emits an unbroken stream of static.
control panel: You hear nothing from the control panel.

>listen
Total silence.