Silent Stars
An Interactive Fiction by Zaq Grow
Release 1 / Serial number 130426 / Inform 7 build 6G60 (I6/v6.32 lib 6/12N) SD

Antiseptic Coffin, in dim light
You're lying down inside a metal coffin that isn't much larger than you. It (you?) reeks of medical disinfectants; the fuzziness in your head feels like it's keeping away a headache from all the fumes.

A small plastex hatch window is set into the hatch above you.

A flashing red button on the control panel above you casts flickering shadows.

>press cycle
The cycle button fades from red to green and blinks "Cycle Complete" a couple times.

Above, a stone falls.
The water glows with pale light.
Ripples lap the shore.

>press unlock
The button flashes a couple times; there is a metallic click as the locks disengage.

The pale gleam recedes.
Inky dark cloaks the water.
The waves settle down.

>press exit
A beat passes, and then the gasket on the exit button disengages with a whoosh of pressurized air. The stench of old blood quickly replaces the tang of disinfectants.

>out
You sit up, lift open the hatch with one shoulder, and roll over the lip of the autodoc. The fall to the ground is thankfully short.

Medical Bay, in dim light
You make a splash instead of a thud when you land. As you raise your {{drug-addled}} head to look, you choke down the urge to vomit as you realize the syrupy black gunk coating your arms up to the bicep is half-dried blood. The puddle is almost ankle-deep and wall-to-wall.

 {{"Disarray" is putting it mildly:}} every single cabinet in the room is open and empty. Some of the doors have been torn off the hinges and lie mangled in a corner. The grey tile floor is littered with broken glass, bits of medical paraphernalia, and dried blood.

The dark hulk of the autodoc crouches in one corner.

A green vinyl curtain is drawn across the entrance to a small chemical shower.

A rack of gear lockers along one wall have received a similar treatment as the cabinets. Three of them appear to be intact, though locked.

A giant pile of debris lies more or less in the corner.

The lambency from an emergency lightstrip illuminates a medical hatch.

>in
Antiseptic Coffin, in dim light
You're lying down inside a metal coffin that isn't much larger than you. It (you?) reeks of medical disinfectants; the fuzziness in your head feels like it's keeping away a headache from all the fumes.

A small plastex hatch window is set into the hatch above you.

The control panel above you awaits input.

>out
Medical Bay, in dim light
 "Disarray" is putting it mildly: every single cabinet in the room is open and empty. Some of the doors have been torn off the hinges and lie mangled in a corner. The grey tile floor is littered with broken glass, bits of medical paraphernalia, and dried blood.

A dark plastex porthole is set into the hatch of the autodoc.

The lightness from the control panel limns a Medical hatch.

>lumos
{{The light level in the Medical Bay qualifies for: dim }}
{{Light-bearing things: emergency lightstrip}}

>showme panel
control panel - panel
    cycle button (part of control panel) - toggle
    unlock button (part of control panel) - pushbutton
    exit button (part of control panel) - pushbutton
location: in the Antiseptic Coffin
singular-named, improper-named; lit, inedible, fixed in place, neuter, ordinarily enumerated, seen, unfamiliar, mundane, unexamined, cold, dim, diffuse; inactive
printed name: "control panel"
printed plural name: "panels"
indefinite article: "the"
description: "The edges of the control panel have some biogunk in them."
initial appearance: "The control panel above you awaits input."
bulk: 1
dark-description: "An amber-colored control panel shines wan light onto your sternum."
sound: "silence"
sound-description: "This does not make noise."
color: silver
carrying capacity: 100
readout: "Autodoc Inactive"

>close autodoc
You can't see any such thing.

>close hatch
Which do you mean, the hatch, the hatch window or the Medical hatch?

>autodoc's hatch
There is a hiss of air as the hatch seals pressurize.

>look
Medical Bay, in dim light
 "Disarray" is putting it mildly: every single cabinet in the room is open and empty. Some of the doors have been torn off the hinges and lie mangled in a corner. The grey tile floor is littered with broken glass, bits of medical paraphernalia, and dried blood.

A dark plastex porthole is set into the hatch of the autodoc.

The gleam from the control panel reveals a Medical hatch.

>look
Medical Bay, in dim light
 "Disarray" is putting it mildly: every single cabinet in the room is open and empty. Some of the doors have been torn off the hinges and lie mangled in a corner. The grey tile floor is littered with broken glass, bits of medical paraphernalia, and dried blood.

A dark plastex porthole is set into the hatch of the autodoc.

The control panel shines on a Medical hatch.

>look
Medical Bay, in dim light
 "Disarray" is putting it mildly: every single cabinet in the room is open and empty. Some of the doors have been torn off the hinges and lie mangled in a corner. The grey tile floor is littered with broken glass, bits of medical paraphernalia, and dried blood.

A dark plastex porthole is set into the hatch of the autodoc.

The stone here limns a Medical hatch.

>showme stone
stone here - thing
location: in the lower pool
singular-named, improper-named; lit, inedible, portable, neuter, ordinarily enumerated, unseen, unfamiliar, mundane, unexamined, cold, dim, diffuse, infrared
printed name: "stone here"
printed plural name: none
indefinite article: none
description: "Ivory colored quartz.
Cloudy, like a summer day.
Warmer than skin heat."
initial appearance: "Under you, a stone.
It glows like a faint firefly.
Pale white, and falling."
bulk: 1
dark-description: "(dark desc is empty)
Ivory colored quartz.
Cloudy, like a summer day.
Warmer than skin heat.
"
sound: "silence"
sound-description: "This does not make noise."
color: silver

>x lightstrip
Nope!

* * *

>x stone
You can't see any such thing.

* * *

>enter shower
(the chemical shower)
That's not something you can open.

(first opening the shower curtain)
You get into the chemical shower.

>open shower
(the chemical shower)
That's not something you can open.

>rules
Rules tracing now switched on. Type "rules off" to switch it off again, or "rules all" to include even rules which do not apply.

>open shower
(the chemical shower)
[Rule "can't open unless openable rule" applies.]
That's not something you can open.

>enter shower
(the chemical shower)
[Rule "Before entering the chemical shower" applies.]
[Rule "can't open unless openable rule" applies.]
That's not something you can open.

(first opening the shower curtain)
[Rule "convert enter door into go rule" applies.]
[Rule "convert enter compass direction into go rule" applies.]
[Rule "can't enter what's already entered rule" applies.]
But you're already in the chemical shower.

* * *

>enter shower
(the chemical shower)
[Rule "Before entering the chemical shower" applies.]
[Rule "can't open unless openable rule" applies.]
That's not something you can open.

(first opening the shower curtain)
[Rule "convert enter door into go rule" applies.]
[Rule "convert enter compass direction into go rule" applies.]
[Rule "can't enter what's already entered rule" applies.]
[Rule "can't enter what's not enterable rule" applies.]
[Rule "can't enter closed containers rule" applies.]
[Rule "can't enter something carried rule" applies.]
[Rule "implicitly pass through other barriers rule" applies.]
[Rule "standard entering rule" applies.]
[Rule "standard report entering rule" applies.]
You get into the chemical shower.

[Rule "describe contents entered into rule" applies.]
[Rule "don't mention player's supporter in room descriptions rule" applies.]
[Rule "don't mention scenery in room descriptions rule" applies.]
[Rule "don't mention undescribed items in room descriptions rule" applies.]
[Rule "set pronouns from items in room descriptions rule" applies.]
[Rule "offer items to writing a paragraph about rule" applies.]
[Rule "use initial appearance in room descriptions rule" applies.]

>showme shower
(the chemical shower)
chemical shower - open container
    vinyl shower curtain (part of chemical shower)
        curtain rod (part of vinyl shower curtain)
    yourself - person
        left hand (part of yourself)
        right hand (part of yourself)
        sunrod - device
location: in the Medical Bay
singular-named, improper-named; unlit, inedible, portable, neuter, ordinarily enumerated, seen, unfamiliar, mundane, unexamined, cold, dim, diffuse; enterable, opaque, open, unopenable, unlocked
printed name: "chemical shower"
printed plural name: "containers"
indefinite article: none
description: "The humble chemical shower is equipped with a variety of {{anti-chemical chemicals}} and its own fluid reclamation system."
initial appearance: "A green vinyl curtain is drawn across the entrance to a small chemical shower."
bulk: 1
dark-description: "(dark desc is empty)
The humble chemical shower is equipped with a variety of {{anti-chemical chemicals}} and its own fluid reclamation system.
"
sound: "silence"
sound-description: "This does not make noise."
color: silver
carrying capacity: 100
bulk capacity: 10

* * *

>rules
Rules tracing now switched on. Type "rules off" to switch it off again, or "rules all" to include even rules which do not apply.

>enter shower
(the chemical shower)
[Rule "Before entering the chemical shower" applies.]
[Rule "can't open unless openable rule" applies.]
That's not something you can open.

(first opening the shower curtain)
[Rule "convert enter door into go rule" applies.]
[Rule "convert enter compass direction into go rule" applies.]
[Rule "can't enter what's already entered rule" applies.]
[Rule "can't enter what's not enterable rule" applies.]
[Rule "can't enter closed containers rule" applies.]
[Rule "can't enter something carried rule" applies.]
[Rule "implicitly pass through other barriers rule" applies.]
[Rule "standard entering rule" applies.]
[Rule "standard report entering rule" applies.]
You get into the chemical shower.

[Rule "describe contents entered into rule" applies.]
[Rule "don't mention player's supporter in room descriptions rule" applies.]
[Rule "don't mention scenery in room descriptions rule" applies.]
[Rule "don't mention undescribed items in room descriptions rule" applies.]
[Rule "set pronouns from items in room descriptions rule" applies.]
[Rule "offer items to writing a paragraph about rule" applies.]
[Rule "use initial appearance in room descriptions rule" applies.]

>showme shower
(the chemical shower)
chemical shower - open container
    vinyl shower curtain (part of chemical shower)
        curtain rod (part of vinyl shower curtain)
    yourself - person
        left hand (part of yourself)
        right hand (part of yourself)
        sunrod - device
location: in the Medical Bay
singular-named, improper-named; unlit, inedible, portable, neuter, ordinarily enumerated, seen, unfamiliar, mundane, unexamined, cold, dim, diffuse; enterable, opaque, open, openable, unlocked
printed name: "chemical shower"
printed plural name: "containers"
indefinite article: none
description: "The humble chemical shower is equipped with a variety of {{anti-chemical chemicals}} and its own fluid reclamation system."
initial appearance: "A green vinyl curtain is drawn across the entrance to a small chemical shower."
bulk: 1
dark-description: "(dark desc is empty)
The humble chemical shower is equipped with a variety of {{anti-chemical chemicals}} and its own fluid reclamation system.
"
sound: "silence"
sound-description: "This does not make noise."
color: silver
carrying capacity: 100
bulk capacity: 10

* * *

>x debris
You can't see any such thing.

>x junk
Most of it looks to be wreckage from whatever went berserk in here. Strange, that all of it's been piled up here in the corner.

>x junk
Most of it looks to be wreckage from whatever went berserk in here.

* * *

Silent Stars
An Interactive Fiction by Zaq Grow
Release 1 / Serial number 130426 / Inform 7 build 6G60 (I6/v6.32 lib 6/12N) SD

Antiseptic Coffin, in dim light
You're lying down inside a metal coffin that isn't much larger than you. It (you?) reeks of medical disinfectants; the fuzziness in your head feels like it's keeping away a headache from all the fumes.

A small plastex hatch window is set into the hatch above you.

A flashing red button on the control panel above you casts flickering shadows.

>x water
You dip your fingers.
Deathly cold, then painful heat.
You flinch back, anxious.

A shining stone falls.
The water glows with pale light.
Ripples lap the shore.