Silent Stars
An Interactive Fiction by Zaq Grow
Release 1 / Serial number 130422 / Inform 7 build 6G60 (I6/v6.32 lib 6/12N) SD

Antiseptic Coffin, in dim light
You're lying down inside a metal coffin that isn't much larger than you. It (you?) reeks of medical disinfectants; the fuzziness in your head feels like it's keeping away a headache from all the fumes.

A small plastex hatch window is set into the hatch above you.

A flashing red button on the control panel above you casts flickering shadows.

>press cycle
SWITCH OFF.

You switch the cycle button off.

The cycle button fades from red to green and blinks "Cycle Complete" a couple times.

Under you, a stone.
It glows like a faint firefly.
Pale white, and falling.

Above, a stone falls.
The water glows with pale light.
Ripples lap the shore.

>press unlock
SWITCH ON.

You switch the unlock button on.

The "Unlock Hatch" unlock button changes to green.

Nothing obvious happens.

The pale gleam recedes.
Inky dark cloaks the water.
The waves settle down.

>press exit
SWITCH ON.

You switch the exit button on.

A beat passes, and then the gasket on the exit button disengages with a whoosh of pressurized air. The stench of old blood quickly replaces the tang of disinfectants.

Nothing obvious happens.

>out
You sit up, shouldering open the hatch, and climb over the edge. The fall to the ground is short.

Medical Bay, in the gloom
(dark desc is empty)
The Medical Bay: filled with all the pointy and invasive tools of the trade.

* * *

Silent Stars
An Interactive Fiction by Zaq Grow
Release 1 / Serial number 130422 / Inform 7 build 6G60 (I6/v6.32 lib 6/12N) SD

Antiseptic Coffin, in dim light
You're lying down inside a metal coffin that isn't much larger than you. It (you?) reeks of medical disinfectants; the fuzziness in your head feels like it's keeping away a headache from all the fumes.

A small plastex hatch window is set into the hatch above you.

A flashing red button on the control panel above you casts flickering shadows.

>x water
You dip your fingers.
Deathly cold, then painful heat.
You flinch back, anxious.

A shining stone falls.
The water glows with pale light.
Ripples lap the shore.

* * *

Silent Stars
An Interactive Fiction by Zaq Grow
Release 1 / Serial number 130422 / Inform 7 build 6G60 (I6/v6.32 lib 6/12N) SD

Antiseptic Coffin, in dim light
You're lying down inside a metal coffin that isn't much larger than you. It (you?) reeks of medical disinfectants; the fuzziness in your head feels like it's keeping away a headache from all the fumes.

A small plastex hatch window is set into the hatch above you.

A flashing red button on the control panel above you casts flickering shadows.

>push unlock button
ERROR: Completion of surgery cycle has not been confirmed.

The pale gleam recedes.
Inky dark cloaks the water.
The waves settle down.

* * *

Silent Stars
An Interactive Fiction by Zaq Grow
Release 1 / Serial number 130422 / Inform 7 build 6G60 (I6/v6.32 lib 6/12N) SD

Antiseptic Coffin, in dim light
You're lying down inside a metal coffin that isn't much larger than you. It (you?) reeks of medical disinfectants; the fuzziness in your head feels like it's keeping away a headache from all the fumes.

A small plastex hatch window is set into the hatch above you.

A flashing red button on the control panel above you casts flickering shadows.

>press red button
The cycle button fades from red to green and blinks "Cycle Complete" a couple times.

Under you, a stone.
It glows like a faint firefly.
Pale white, and falling.

Above, a stone falls.
The water glows with pale light.
Ripples lap the shore.

* * *

Silent Stars
An Interactive Fiction by Zaq Grow
Release 1 / Serial number 130422 / Inform 7 build 6G60 (I6/v6.32 lib 6/12N) SD

Antiseptic Coffin, in dim light
You're lying down inside a metal coffin that isn't much larger than you. It (you?) reeks of medical disinfectants; the fuzziness in your head feels like it's keeping away a headache from all the fumes.

A small plastex hatch window is set into the hatch above you.

A flashing red button on the control panel above you casts flickering shadows.

>press flashing button
You can't see any such thing.

* * *

Silent Stars
An Interactive Fiction by Zaq Grow
Release 1 / Serial number 130422 / Inform 7 build 6G60 (I6/v6.32 lib 6/12N) SD

Antiseptic Coffin, in dim light
You're lying down inside a metal coffin that isn't much larger than you. It (you?) reeks of medical disinfectants; the fuzziness in your head feels like it's keeping away a headache from all the fumes.

A small plastex hatch window is set into the hatch above you.

A flashing red button on the control panel above you casts flickering shadows.

>push flashing button
The cycle button fades from red to green and blinks "Cycle Complete" a couple times.

Under you, a stone.
It glows like a faint firefly.
Pale white, and falling.

Above, a stone falls.
The water glows with pale light.
Ripples lap the shore.

>push steady button
Which do you mean, the cycle button, the unlock button or the exit button?

* * *

>push flashing button
The cycle button fades from red to green and blinks "Cycle Complete" a couple times.

Under you, a stone.
It glows like a faint firefly.
Pale white, and falling.

Above, a stone falls.
The water glows with pale light.
Ripples lap the shore.

>out
(by pressing the exit button)
ERROR: Completion of surgery cycle has not been confirmed.

The pale gleam recedes.
Inky dark cloaks the water.
The waves settle down.

>showme control panel
control panel - panel
    cycle button (part of control panel) - button
    unlock button (part of control panel) - button
    exit button (part of control panel) - button
location: in the Antiseptic Coffin
singular-named, improper-named; lit, inedible, fixed in place, neuter, ordinarily enumerated, seen, unfamiliar, mundane, unexamined, cold, dim, diffuse; active
printed name: "control panel"
printed plural name: "panels"
indefinite article: "the"
description: "The edges of the control panel have some biogunk in them."
initial appearance: "A flashing red button on the control panel above you casts flickering shadows."
bulk: 1
dark-description: "An amber-colored control panel shines wan light onto your sternum."
sound: "silence"
sound-description: "This does not make noise."
color: silver
carrying capacity: 100
readout: "Confirm Amputation Surgery Cycle Has Completed"

>showme cycle button
cycle button - button
location: part of the control panel in the Antiseptic Coffin
singular-named, improper-named; unlit, inedible, fixed in place, neuter, ordinarily enumerated, seen, unfamiliar, mundane, unexamined, cold, dim, diffuse; switched off; flashing
printed name: "cycle button"
printed plural name: "buttons"
indefinite article: none
description: "It's red and flashing "Confirm?" in big letters."
initial appearance: "A simple button."
bulk: 1
dark-description: "(dark desc is empty)
It's red and flashing "Confirm?" in big letters.
"
sound: "silence"
sound-description: "This does not make noise."
color: red

>push cycle button
The cycle button fades from red to green and blinks "Cycle Complete" a couple times.

>showme cycle button
cycle button - button
location: part of the control panel in the Antiseptic Coffin
singular-named, improper-named; unlit, inedible, fixed in place, neuter, ordinarily enumerated, seen, unfamiliar, mundane, unexamined, cold, dim, diffuse; switched on; flashing
printed name: "cycle button"
printed plural name: "buttons"
indefinite article: none
description: "It's red and flashing "Confirm?" in big letters."
initial appearance: "A simple button."
bulk: 1
dark-description: "(dark desc is empty)
It's red and flashing "Confirm?" in big letters.
"
sound: "silence"
sound-description: "This does not make noise."
color: red

>x cycle button
It's red and flashing "Confirm?" in big letters.

The cycle button is currently switched on.

>push cycle button
The cycle button fades from red to green and blinks "Cycle Complete" a couple times.

* * *

Silent Stars
An Interactive Fiction by Zaq Grow
Release 1 / Serial number 130422 / Inform 7 build 6G60 (I6/v6.32 lib 6/12N) SD

Antiseptic Coffin, in dim light
You're lying down inside a metal coffin that isn't much larger than you. It (you?) reeks of medical disinfectants; the fuzziness in your head feels like it's keeping away a headache from all the fumes.

A small plastex hatch window is set into the hatch above you.

A flashing red button on the control panel above you casts flickering shadows.

>push cycle button
The cycle button fades from red to green and blinks "Cycle Complete" a couple times.

Under you, a stone.
It glows like a faint firefly.
Pale white, and falling.

Above, a stone falls.
The water glows with pale light.
Ripples lap the shore.

>rules
Rules tracing now switched on. Type "rules off" to switch it off again, or "rules all" to include even rules which do not apply.

>push cycle button
[Rule "can't push scenery rule" applies.]
[Rule "can't push people rule" applies.]
[Rule "Carry out pushing a button ( called the frobber )" applies.]
[Rule "Report pushing the cycle button" applies.]
The cycle button fades from red to green and blinks "Cycle Complete" a couple times.

[Rule "Every turn while the stone is in the upper pool" applies.]
The pale gleam recedes.
Inky dark cloaks the water.
The waves settle down.

* * *

>push cycle button
The cycle button fades from red to green and blinks "Cycle Complete" a couple times.

Under you, a stone.
It glows like a faint firefly.
Pale white, and falling.

Above, a stone falls.
The water glows with pale light.
Ripples lap the shore.

>showme cycle button
cycle button - button
location: part of the control panel in the Antiseptic Coffin
singular-named, improper-named; unlit, inedible, fixed in place, neuter, ordinarily enumerated, seen, unfamiliar, mundane, unexamined, cold, dim, diffuse; switched off; flashing
printed name: "cycle button"
printed plural name: "buttons"
indefinite article: none
description: "It's red and flashing "Confirm?" in big letters."
initial appearance: "A simple button."
bulk: 1
dark-description: "(dark desc is empty)
It's red and flashing "Confirm?" in big letters.
"
sound: "silence"
sound-description: "This does not make noise."
color: red

>push cycle button
SWITCH ON.

The cycle button fades from red to green and blinks "Cycle Complete" a couple times.

The pale gleam recedes.
Inky dark cloaks the water.
The waves settle down.

>showme cycle button
cycle button - button
location: part of the control panel in the Antiseptic Coffin
singular-named, improper-named; unlit, inedible, fixed in place, neuter, ordinarily enumerated, seen, unfamiliar, mundane, unexamined, cold, dim, diffuse; switched on; flashing
printed name: "cycle button"
printed plural name: "buttons"
indefinite article: none
description: "It's red and flashing "Confirm?" in big letters."
initial appearance: "A simple button."
bulk: 1
dark-description: "(dark desc is empty)
It's red and flashing "Confirm?" in big letters.
"
sound: "silence"
sound-description: "This does not make noise."
color: red

* * *

>push cycle button
The cycle button fades from red to green and blinks "Cycle Complete" a couple times.

Under you, a stone.
It glows like a faint firefly.
Pale white, and falling.

Above, a stone falls.
The water glows with pale light.
Ripples lap the shore.

>x cycle button
It's now a blank grey button.

The cycle button is currently switched off.

The pale gleam recedes.
Inky dark cloaks the water.
The waves settle down.

>push cycle butotn
You can't see any such thing.

>push cycle button
SWITCH ON.

You switch the cycle button on.

The cycle button fades from red to green and blinks "Cycle Complete" a couple times.

>x cycle button
It's green and says "Start Cycle?"

The cycle button is currently switched on.

* * *

>x cycle button
It's now a blank grey button.

The cycle button is currently switched off.

The pale gleam recedes.
Inky dark cloaks the water.
The waves settle down.

>rules
Rules tracing now switched on. Type "rules off" to switch it off again, or "rules all" to include even rules which do not apply.

>x cycle button
[Rule "mark items as seen on examining rule" applies.]
[Rule "standard examining rule" applies.]
It's now a blank grey button.

[Rule "new examine directions rule" applies.]
[Rule "examine containers rule" applies.]
[Rule "examine supporters rule" applies.]
[Rule "examine devices rule" applies.]
The cycle button is currently switched off.

[Rule "examine undescribed things rule" applies.]
[Rule "report other people examining rule" applies.]

* * *

>push cycle button
The cycle button fades from red to green and blinks "Cycle Complete" a couple times.

Under you, a stone.
It glows like a faint firefly.
Pale white, and falling.

Above, a stone falls.
The water glows with pale light.
Ripples lap the shore.

>actions
Actions listing on.

>push cycle button
[pushing the cycle button]
[(1) switching on the cycle button]
You switch the cycle button on.
[(1) switching on the cycle button - succeeded]

[pushing the cycle button - succeeded]

The pale gleam recedes.
Inky dark cloaks the water.
The waves settle down.

* * *

>push cycle button
The cycle button fades from red to green and blinks "Cycle Complete" a couple times.

Under you, a stone.
It glows like a faint firefly.
Pale white, and falling.

Above, a stone falls.
The water glows with pale light.
Ripples lap the shore.

>push unlock button
The button flashes a couple times; there is a metallic click as the locks disengage.

Nothing obvious happens.

The pale gleam recedes.
Inky dark cloaks the water.
The waves settle down.

>actions
Actions listing on.

>push unlock button
[pushing the unlock button]
The button flashes a couple times; there is a metallic click as the locks disengage.

Nothing obvious happens.
[pushing the unlock button - succeeded]

>rules
Rules tracing now switched on. Type "rules off" to switch it off again, or "rules all" to include even rules which do not apply.

>push unlock button
[pushing the unlock button]
[Rule "Check pushing the unlock button" applies.]
[Rule "can't push scenery rule" applies.]
[Rule "can't push people rule" applies.]
[Rule "Carry out pushing the unlock button" applies.]
[Rule "Report pushing the unlock button" applies.]
The button flashes a couple times; there is a metallic click as the locks disengage.

[Rule "report pushing rule" applies.]
Nothing obvious happens.
[pushing the unlock button - succeeded]

* * *

>push cycle button
The cycle button fades from red to green and blinks "Cycle Complete" a couple times.

Under you, a stone.
It glows like a faint firefly.
Pale white, and falling.

Above, a stone falls.
The water glows with pale light.
Ripples lap the shore.

>push unlock buttn
You can't see any such thing.

>push unlock button
The button flashes a couple times; there is a metallic click as the locks disengage.

Beep!

The pale gleam recedes.
Inky dark cloaks the water.
The waves settle down.

>x cycle button
It's now a blank grey button.

* * *

Silent Stars
An Interactive Fiction by Zaq Grow
Release 1 / Serial number 130422 / Inform 7 build 6G60 (I6/v6.32 lib 6/12N) SD

Antiseptic Coffin, in dim light
You're lying down inside a metal coffin that isn't much larger than you. It (you?) reeks of medical disinfectants; the fuzziness in your head feels like it's keeping away a headache from all the fumes.

A small plastex hatch window is set into the hatch above you.

A flashing red button on the control panel above you casts flickering shadows.

>rules
Rules tracing now switched on. Type "rules off" to switch it off again, or "rules all" to include even rules which do not apply.

>press cycle button
[Rule "can't push scenery rule" applies.]
[Rule "can't push people rule" applies.]
[Rule "Carry out pushing a button ( called the frobber )" applies.]
SWITCH OFF.

[Rule "can't switch off unless switchable rule" applies.]
[Rule "can't switch off what's already off rule" applies.]
[Rule "Carry out switching off the cycle button" applies.]
[Rule "standard switching off rule" applies.]
[Rule "standard report switching off rule" applies.]
You switch the cycle button off.

[Rule "Report pushing the cycle button" applies.]
The cycle button fades from red to green and blinks "Cycle Complete" a couple times.

[Rule "Every turn while the location of the stone is below the location of the player" applies.]
Under you, a stone.
It glows like a faint firefly.
Pale white, and falling.

Above, a stone falls.
The water glows with pale light.
Ripples lap the shore.

>press unlock button
[Rule "Check pushing the unlock button" applies.]
[Rule "can't push scenery rule" applies.]
[Rule "can't push people rule" applies.]
[Rule "Carry out pushing the unlock button" applies.]
[Rule "Carry out pushing a button ( called the frobber )" applies.]
SWITCH ON.

[Rule "can't switch on unless switchable rule" applies.]
[Rule "can't switch on what's already on rule" applies.]
[Rule "standard switching on rule" applies.]
[Rule "standard report switching on rule" applies.]
You switch the unlock button on.

[Rule "Report pushing the unlock button" applies.]
The "Unlock Hatch" unlock button changes to green.

[Rule "report pushing rule" applies.]
Nothing obvious happens.

[Rule "Every turn while the stone is in the upper pool" applies.]
The pale gleam recedes.
Inky dark cloaks the water.
The waves settle down.

* * *

Silent Stars
An Interactive Fiction by Zaq Grow
Release 1 / Serial number 130422 / Inform 7 build 6G60 (I6/v6.32 lib 6/12N) SD

Antiseptic Coffin, in dim light
You're lying down inside a metal coffin that isn't much larger than you. It (you?) reeks of medical disinfectants; the fuzziness in your head feels like it's keeping away a headache from all the fumes.

A small plastex hatch window is set into the hatch above you.

A flashing red button on the control panel above you casts flickering shadows.

>x panel
The edges of the control panel have some biogunk in them.

Control Panel Readout: "Confirm Amputation Surgery Cycle Has Completed"
three rhombus-shaped buttons are outlined: a cycle button, an unlock button and an exit button.

Under you, a stone.
It glows like a faint firefly.
Pale white, and falling.

Above, a stone falls.
The water glows with pale light.
Ripples lap the shore.

* * *

Silent Stars
An Interactive Fiction by Zaq Grow
Release 1 / Serial number 130422 / Inform 7 build 6G60 (I6/v6.32 lib 6/12N) SD

Antiseptic Coffin, in dim light
You're lying down inside a metal coffin that isn't much larger than you. It (you?) reeks of medical disinfectants; the fuzziness in your head feels like it's keeping away a headache from all the fumes.

A small plastex hatch window is set into the hatch above you.

A flashing red button on the control panel above you casts flickering shadows.

>press cycle button
The cycle button fades from red to green and blinks "Cycle Complete" a couple times.

Under you, a stone.
It glows like a faint firefly.
Pale white, and falling.

Above, a stone falls.
The water glows with pale light.
Ripples lap the shore.

>push unlock button
The button flashes a couple times; there is a metallic click as the locks disengage.

The pale gleam recedes.
Inky dark cloaks the water.
The waves settle down.

>push exit button
A beat passes, and then the gasket on the exit button disengages with a whoosh of pressurized air. The stench of old blood quickly replaces the tang of disinfectants.

Beep!

>out
You sit up, shouldering open the hatch, and climb over the edge. The fall to the ground is short.

Medical Bay, in the darkness
(dark desc is empty)
The Medical Bay: filled with all the pointy and invasive tools of the trade.