Silent Stars
An Interactive Fiction by Zaq Grow
Release 1 / Serial number 130411 / Inform 7 build 6G60 (I6/v6.32 lib 6/12N) SD

Antiseptic Coffin, in dim light
You're lying down inside a metal coffin that isn't much larger than you. It (you?) reeks of medical disinfectants; the fuzziness in your head feels like it's keeping away a headache from all the fumes.

A small plastex hatch window is set into the hatch above you.

The control panel above you shows a blinking red button.

>press cycle
The button changes to green and blinks "Completed" a couple times.

* * *

Silent Stars
An Interactive Fiction by Zaq Grow
Release 1 / Serial number 130411 / Inform 7 build 6G60 (I6/v6.32 lib 6/12N) SD

Antiseptic Coffin, in dim light
You're lying down inside a metal coffin that isn't much larger than you. It (you?) reeks of medical disinfectants; the fuzziness in your head feels like it's keeping away a headache from all the fumes.

A small plastex hatch window is set into the hatch above you.

The control panel above you shows a blinking red button.

>x water
You dip your fingers.
Deathly cold, then painful heat.
You flinch back, anxious.

A shining stone falls.
The water glows with pale light.
Ripples lap the shore.

>take stone
You plunge a hand in.
It's like bare skin in deep space.
Sensation departs.

Struggling brings nothing.
To reach flesh you must dive in.
Commit all, or none.

A white stone descends.
It glows like a faint firefly.
Pale white, and fading.

The pale gleam recedes.
Inky dark cloaks the water.
The waves settle down.

>dive in
One breath, plus one held.
Even your bones feel like ice.
Darkness shrouds your thoughts.

upper pool, in the darkness
(DARK DESC)
The water is still.
 Shadows crowd in overhead.
 The silence deafens.

A white stone descends.
It glows like a faint firefly.
Pale white, and fading.

>dive
The light calls you down.
You kick your legs, jaw clenched.
Frost tightens your chest.

lower pool, in dim light
The bottom is smooth.
 No signs of life scar the mud.
 Your guts feel frostbit.

Before you, a stone.
It glows like a faint firefly.
Pale white, and fading.

>take stone
Taken.

The smell of burning electronics hits your lizard hindbrain like a rivet gun and you awaken almost immediately, limbs flailing against the sides of the coffin. A badly-milled bolt opens a bloody streak on the back of your wrist, and several seconds pass before you realize you can't feel it because you're completely numb.

 ...

 The smoke smell drifts by your nose again, a little stronger. You startle and bark your forehead on the plastex window above you. The pain keeps you awake this time.

Antiseptic Coffin, in dim light
You're lying down inside a metal coffin that isn't much larger than you. It (you?) reeks of medical disinfectants; the fuzziness in your head feels like it's keeping away a headache from all the fumes.

A small plastex window is set into the hatch above you.

The control panel above you shows a blinking red button.

* * *

Silent Stars
An Interactive Fiction by Zaq Grow
Release 1 / Serial number 130411 / Inform 7 build 6G60 (I6/v6.32 lib 6/12N) SD

Antiseptic Coffin, in dim light
You're lying down inside a metal coffin that isn't much larger than you. It (you?) reeks of medical disinfectants; the fuzziness in your head feels like it's keeping away a headache from all the fumes.

A small plastex hatch window is set into the hatch above you.

The control panel above you shows a blinking red button.

I guess we got a little big for our britches. If I never see the inside of a spacecan again it'll be too soon.

You know the weirdest part for me was the dreams? A bunch of other vets say the same thing, that cryo does something to your subconscious. Of course the headshrinkers never find real proof of change; that green gel shit they pump into your lungs and around you in the spacecan "has been proven to prevent tissue damage in all but extraordinarily high fractions of sublight speed", but that doesn't change your dreams back.

Nothing does, so far as anyone knows. And these other jokers, they had successful missions, or even just break-even missions. Their dreams are a little weird, otherwise pleasant or at worst harmless.

I'm the only one with a void file, the only one who came back from the Starlight Dancer. My dreams are blackest cold, the chill the sinners lying under Cocytus must feel at night. I can feel the frost reach down my throat, right into the bottom of my lungs where the death rattle must be. The frost never quite melts back out afterward, and right there next to your guts for the rest of your life is a little puddle of ice water.

It hurts like crazy.
Silent Stars
An Interactive Fiction by Zaq Grow
Release 1 / Serial number 130408 / Inform 7 build 6G60 (I6/v6.32 lib 6/12N) SD

sharp rocks, in the darkness
(dark desc is empty)
Rocks gnaw your bare feet.
The darkness is a vast cloak.
Nothing lies behind.

Still water cools the air.
It seems to stretch forever.
No waves touch your feet.

>x water
You dip your fingers.
Deathly cold, then painful heat.
You flinch back, anxious.

A shining stone falls.
The water glows with pale light.
Ripples lap the shore.

>take stone
You plunge a hand in.
It's like bare skin in deep space.
Sensation departs.

Struggling brings ruin.
The depths are the only way.
Commit all, or none.

Under you, a stone.
It glows like a faint firefly.
Pale white, and falling.

The pale gleam recedes.
Inky dark cloaks the water.
The waves settle down.

>dive in
One breath, plus one held.
Even your bones feel like ice.
Darkness shrouds your thoughts.

upper pool, in the darkness
(dark desc is empty)
The water is still.
Shadows crowd in overhead.
The silence deafens.

Under you, a stone.
It glows like a faint firefly.
Pale white, and falling.

>take stone
Struggling brings nothing.
To reach flesh you must dive in.
Commit all, or none.

A white stone descends.
It glows like a faint firefly.
Pale white, and fading.

>dive
The light calls you down.
You kick your legs, jaw clenched.
Frost tightens your chest.

lower pool, in dim light
The bottom is smooth.
 No signs of life scar the mud.
 Your guts feel frostbit.

Before you, a stone.
It glows like a faint firefly.
Pale white, and fading.

* * *

>dive in
One breath, plus one held.
Even your bones feel like ice.
Darkness shrouds your thoughts.

upper pool, in the darkness
(dark desc is empty)
The water is still.
Shadows crowd in overhead.
The silence deafens.

Under you, a stone.
It glows like a faint firefly.
Pale white, and falling.

>dive
The light calls you down.
You kick your legs, jaw clenched.
Frost tightens your chest.

lower pool, in dim light
The bottom is smooth.
No signs of life scar the mud.
Your guts feel frostbit.

Before you, a stone.
It glows like a faint firefly.
Pale white, and falling.

>take stone
You reach out, eager.
Chains of ice tug at your limbs.
Your chest burns furnace-hot.

A veil draws across.
Red on black, crimson silk red.
The bright sting of pain.

You gaze at your hand.
Streams of red hang like silk scarves.
The wound glows ruby.

The red glow flickers.
The smell of burning electronics hits your lizard hindbrain like a rivet gun and you awaken almost immediately, limbs flailing against the sides of the coffin. A badly-milled bolt opens a bloody streak on the back of your wrist, and several seconds pass before you realize you can't feel it because you're completely numb.

 ...

 The smoke smell drifts by your nose again, a little stronger. You startle and bark your forehead on the plastex window above you. The pain keeps you awake this time.

Antiseptic Coffin, in dim light
You're lying down inside a metal coffin that isn't much larger than you. It (you?) reeks of medical disinfectants; the fuzziness in your head feels like it's keeping away a headache from all the fumes.

A small plastex window is set into the hatch above you.

The control panel above you shows a blinking red button.

>look
Antiseptic Coffin, in dim light
You're lying down inside a metal coffin that isn't much larger than you. It (you?) reeks of medical disinfectants; the fuzziness in your head feels like it's keeping away a headache from all the fumes.

A small plastex window is set into the hatch above you.

The control panel above you shows a blinking red button.

>showme erika
There seems to be no such object anywhere in the model world.

>showme player
There seems to be no such object anywhere in the model world.

>showme self
Erika - person
    left hand (part of Eirka)
    right hand (part of Ekria)
    snote here
location: in the Antiseptic Coffin
singular-named, proper-named; unlit, inedible, portable, ordinarily enumerated, seen, unfamiliar, mundane, unexamined, cold, dim, diffuse; male, awake, healthy, concussed
printed name: "Erika"
printed plural name: "people"
indefinite article: none
description: "As good-looking as ever."
initial appearance: none
bulk: 20
dark-description: "(dark desc is empty)
As good-looking as ever.
"
sound: "silence"
sound-description: "This does not make noise."
carrying capacity: 100
bulk capacity: 100

* * *

>take stone
You plunge a hand in.
It's like bare skin in deep space.
Sensation departs.

Struggling brings ruin.
The depths are the only way.
Commit all, or none.

Under you, a stone.
It glows like a faint firefly.
Pale white, and falling.

The pale gleam recedes.
Inky dark cloaks the water.
The waves settle down.

>x stone
Admired at range,
the stone's glow waxes and wanes
like a  tiny moon.

>dive
One breath, plus one held.
Even your bones feel like ice.
Darkness shrouds your thoughts.

upper pool, in the darkness
(DARK DESC)
The water is still.
 Shadows crowd in overhead.
 The silence deafens.

Under you, a stone.
It glows like a faint firefly.
Pale white, and falling.

>dive
The light calls you down.
You kick your legs, jaw clenched.
Frost tightens your chest.

lower pool, in dim light
The bottom is smooth.
 No signs of life scar the mud.
 Your guts feel frostbit.

Before you, a stone.
It glows like a faint firefly.
Pale white, and falling.

>take stone
You reach out, eager.
Chains of ice tug at your limbs.
Your chest burns furnace-hot.

A veil draws across.
Red on black, crimson silk red.
The bright sting of pain.

You gaze at your hand.
Streams of red hang like silk scarves.
The wound glows ruby.

The red glow flickers.
The smell of burning electronics hits your lizard hindbrain like a rivet gun and you awaken almost immediately, limbs flailing against the sides of the coffin. A badly-milled bolt opens a bloody streak on the back of your wrist, and several seconds pass before you realize you can't feel it because you're completely numb.

 ...

 The smoke smell drifts by your nose again, a little stronger. You startle and bark your forehead on the plastex window above you. The pain keeps you awake this time.

Antiseptic Coffin, in dim light
You're lying down inside a metal coffin that isn't much larger than you. It (you?) reeks of medical disinfectants; the fuzziness in your head feels like it's keeping away a headache from all the fumes.

A small plastex window is set into the hatch above you.

The control panel above you shows a blinking red button.

* * *

>x water
You dip your fingers.
Deathly cold, then painful heat.
You flinch back, anxious.

A shining stone falls.
The water glows with pale light.
Ripples lap the shore.

>x stone
Admired at range,
the stone's glow waxes and wanes
like a  tiny moon.

A white stone descends.
It glows like a faint firefly.
Pale white, and falling.

The pale gleam recedes.
Inky dark cloaks the water.
The waves settle down.

>take stone
You plunge a hand in.
It's like bare skin in deep space.
Sensation departs.

Struggling brings nothing.
To reach flesh you must dive in.
Commit all, or none.

>dive in
One breath, plus one held.
Even your bones feel like ice.
Darkness shrouds your thoughts.

upper pool, in the darkness
(DARK DESC)
The water is still.
 Shadows crowd in overhead.
 The silence deafens.

A white stone descends.
It glows like a faint firefly.
Pale white, and falling.

>take stone
Struggling brings nothing.
To reach flesh you must dive in.
Commit all, or none.

A white stone descends.
It glows like a faint firefly.
Pale white, and falling.

>showme stone
stone here - thing
location: in the lower pool
singular-named, improper-named; lit, inedible, portable, neuter, ordinarily enumerated, unseen, unfamiliar, mundane, unexamined, cold, dim, diffuse, infrared
printed name: "stone here"
printed plural name: none
indefinite article: none
description: "Ivory colored quartz.
Cloudy, like a summer day.
Warmer than skin heat."
initial appearance: "A white stone descends.
It glows like a faint firefly.
Pale white, and falling."
bulk: 1
dark-description: "(DARK DESC)
Ivory colored quartz.
Cloudy, like a summer day.
Warmer than skin heat.
"
sound: "silence"
sound-description: "This does not make noise."

>take stone
Struggling brings nothing.
To reach flesh you must dive in.
Commit all, or none.

A white stone descends.
It glows like a faint firefly.
Pale white, and falling.

>dive
The light calls you down.
You kick your legs, jaw clenched.
Frost tightens your chest.

lower pool, in dim light
The bottom is smooth.
 No signs of life scar the mud.
 Your guts feel frostbit.

Before you, a stone.
It glows like a faint firefly.
Pale white, and falling.

>take stone
You reach out, eager.

Chains of ice tug at your limbs.

Your chest burns furnace-hot.

A veil draws across.

Your blood, silky crimson red.

The bright sting of pain.

You gaze at your hand.

Streams of red hang like silk scarves.

The wound glows ruby.

The red glow flickers.

Taken.

The smell of burning electronics hits your lizard hindbrain like a rivet gun and you awaken almost immediately, limbs flailing against the sides of the coffin. A badly-milled bolt opens a bloody streak on the back of your wrist, and several seconds pass before you realize you can't feel it because you're completely numb.

 ...

 The smoke smell drifts by your nose again, a little stronger. You startle and bark your forehead on the plastex window above you. The pain keeps you awake this time.

Antiseptic Coffin, in dim light
You're lying down inside a metal coffin that isn't much larger than you. It (you?) reeks of medical disinfectants; the fuzziness in your head feels like it's keeping away a headache from all the fumes.

A small plastex window is set into the hatch above you.

The control panel above you shows a blinking red button.

* * *

It hurts like crazy.
Silent Stars
An Interactive Fiction by Zaq Grow
Release 1 / Serial number 130408 / Inform 7 build 6G60 (I6/v6.32 lib 6/12N) SD

sharp rocks, in the darkness
(dark desc is empty)
Rocks gnaw your bare feet.
The darkness is a vast cloak.
Nothing lies behind.

Still water cools the air.
It seems to stretch forever.
No waves touch your feet.

I beg your pardon?

I beg your pardon?

>x water
You dip your fingers.
Deathly cold, then painful heat.
You flinch back, anxious.

A shining stone falls.
The water glows with pale light.
Ripples lap the shore.

>x stone
Admired at range,
the stone's glow waxes and wanes
like a  tiny moon.

Under you, a stone.
It glows like a faint firefly.
Pale white, and falling.

The pale gleam recedes.
Inky dark cloaks the water.
The waves settle down.

>take stone
You plunge a hand in.
It's like bare skin in deep space.
Sensation departs.

Struggling brings ruin.
The depths are the only way.
Commit all, or none.

>dive in
One breath, plus one held.
Even your bones feel like ice.
Darkness shrouds your thoughts.

upper pool, in the gloom
(DARK DESC)
The water is still.
 Shadows crowd in overhead.
 The silence deafens.

Under you, a stone.
It glows like a faint firefly.
Pale white, and falling.

>take stone
Struggling brings ruin.
The depths are the only way.
Commit all, or none.

Under you, a stone.
It glows like a faint firefly.
Pale white, and falling.

>dive
The light calls you down.
You kick your legs, jaw clenched.
Frost tightens your chest.

lower pool, in dim light
The bottom is smooth.
 No signs of life scar the mud.
 Your guts feel frostbit.

Before you, a stone.
It glows like a faint firefly.
Pale white, and falling.

>take stone
You reach out, eager.
Chains of ice tug at your limbs.
Your chest burns furnace-hot.

A veil draws across.
Red on black, crimson silk red.
The bright sting of pain.

You gaze at your hand.
Streams of red hang like silk scarves.
The wound glows ruby.

The red glow flickers.

Taken.

The smell of burning electronics hits your lizard hindbrain like a rivet gun and you awaken almost immediately, limbs flailing against the sides of the coffin. A badly-milled bolt opens a bloody streak on the back of your wrist, and several seconds pass before you realize you can't feel it because you're completely numb.

 ...

 The smoke smell drifts by your nose again, a little stronger. You startle and bark your forehead on the plastex window above you. The pain keeps you awake this time.

Antiseptic Coffin, in dim light
You're lying down inside a metal coffin that isn't much larger than you. It (you?) reeks of medical disinfectants; the fuzziness in your head feels like it's keeping away a headache from all the fumes.

A small plastex window is set into the hatch above you.

The control panel above you shows a blinking red button.

* * *

Silent Stars
An Interactive Fiction by Zaq Grow
Release 1 / Serial number 130411 / Inform 7 build 6G60 (I6/v6.32 lib 6/12N) SD

Antiseptic Coffin, in dim light
You're lying down inside a metal coffin that isn't much larger than you. It (you?) reeks of medical disinfectants; the fuzziness in your head feels like it's keeping away a headache from all the fumes.

A small plastex hatch window is set into the hatch above you.

The control panel above you shows a blinking red button.

>x
What do you want to examine?

>x
You know the weirdest part for me was the dreams? A bunch of other vets say the same thing, that cryo does something to your subconscious. Of course the headshrinkers never find real proof of change; that green gel shit they pump into your lungs and around you in the spacecan "has been proven to prevent tissue damage in all but extraordinarily high fractions of sublight speed", but that doesn't change your dreams back.

>x
Nothing does, so far as anyone knows. And these other jokers, they had successful missions, or even just break-even missions. Their dreams are a little weird, otherwise pleasant or at worst harmless.

>x
I'm the only one with a void file, the only one who came back from the Starlight Dancer. My dreams are blackest cold, the chill the sinners lying under Cocytus must feel at night. I can feel the frost reach down my throat, right into the bottom of my lungs where the death rattle must be. The frost never quite melts back out afterward, and right there next to your guts for the rest of your life is a little puddle of ice water.

>x
It hurts like crazy.
Silent Stars
An Interactive Fiction by Zaq Grow
Release 1 / Serial number 130408 / Inform 7 build 6G60 (I6/v6.32 lib 6/12N) SD

gravelly rocks, in the shadows
(dark desc is empty)
Rocks gnaw your bare feet.
The darkness is a vast cloak.
Nothing lies behind.

Still water cools the air.
It seems to stretch forever.
No waves touch your feet.

>x left hand
It is pitch dark, and you can't see a thing.

A shining stone falls.
The water glows with pale light.
Ripples lap the shore.

>x left hand
It is pitch dark, and you can't see a thing.

Under you, a stone.
It glows like a faint firefly.
Pale white, and falling.

The pale gleam recedes.
Inky dark cloaks the water.
The waves settle down.

>dive in
One breath, plus one held.
Even your bones feel like ice.
Darkness shrouds your thoughts.

upper pool, in the shadows
(dark desc is empty)
The water is still.
Shadows crowd in overhead.
The silence deafens.

Under you, a stone.
It glows like a faint firefly.
Pale white, and falling.

>x left hand
It is pitch dark, and you can't see a thing.

Under you, a stone.
It glows like a faint firefly.
Pale white, and falling.

>down
lower pool, in dim light
The bottom is smooth.
No signs of life scar the mud.
Your guts feel frostbit.

Before you, a stone.
It glows like a faint firefly.
Pale white, and falling.

>x left hand
It's your left hand. Missing fingertip on middle finger (bar fight), blank pinky fingerprint (close call with industrial acid), inoculation and transit scars on the back (expensive counterfeits).

>dive in
There's nothing to dive into here.

>dive
There's nothing to dive into here.

>take stone
You reach out, eager.
Chains of ice tug at your limbs.
Your chest burns furnace-hot.

A veil draws across.
Red on black, crimson silk red.
The bright sting of pain.

You gaze at your hand.
Streams of red hang like silk scarves.
The wound glows ruby.

* * *

>x
What do you want to examine?

>panel
The edges of the control panel have some biogunk in them.

Under you, a stone.
It glows like a faint firefly.
Pale white, and falling.

Above, a stone falls.
The water glows with pale light.
Ripples lap the shore.

* * *

Silent Stars
An Interactive Fiction by Zaq Grow
Release 1 / Serial number 130411 / Inform 7 build 6G60 (I6/v6.32 lib 6/12N) SD

Antiseptic Coffin, in dim light
You're lying down inside a metal coffin that isn't much larger than you. It (you?) reeks of medical disinfectants; the fuzziness in your head feels like it's keeping away a headache from all the fumes.

A small plastex hatch window is set into the hatch above you.

The control panel above you shows a blinking red button.

>look
Antiseptic Coffin, in dim light
You're lying down inside a metal coffin that isn't much larger than you. It (you?) reeks of medical disinfectants; the fuzziness in your head feels like it's keeping away a headache from all the fumes.

A small plastex hatch window is set into the hatch above you.

The control panel above you shows a blinking red button.

Under you, a stone.
It glows like a faint firefly.
Pale white, and falling.

Above, a stone falls.
The water glows with pale light.
Ripples lap the shore.

>x
What do you want to examine?

>panel
The edges of the control panel have some biogunk in them.

The pale gleam recedes.
Inky dark cloaks the water.
The waves settle down.

>showme self
Eirka - person
    left hand (part of Eikra)
    right hand (part of Ekria)
location: in the Antiseptic Coffin
singular-named, proper-named; unlit, inedible, portable, ordinarily enumerated, seen, unfamiliar, mundane, unexamined, cold, dim, diffuse; male, awake, healthy, concussed
printed name: "Erika"
printed plural name: "people"
indefinite article: none
description: "As good-looking as ever."
initial appearance: none
bulk: 20
dark-description: "(dark desc is empty)
As good-looking as ever.
"
sound: "silence"
sound-description: "This does not make noise."
carrying capacity: 100
bulk capacity: 100

>look
Antiseptic Coffin, in dim light
You're lying down inside a metal coffin that isn't much larger than you. It (you?) reeks of medical disinfectants; the fuzziness in your head feels like it's keeping away a headache from all the fumes.

A small plastex hatch window is set into the hatch above you.

The control panel above you shows a blinking red button.

* * *

>look
Antiseptic Coffin, in dim light
You're lying down inside a metal coffin that isn't much larger than you. It (you?) reeks of medical disinfectants; the fuzziness in your head feels like it's keeping away a headache from all the fumes.

A small plastex hatch window is set into the hatch above you.

The control panel above you shows a blinking red button.

Under you, a stone.
It glows like a faint firefly.
Pale white, and falling.

Above, a stone falls.
The water glows with pale light.
Ripples lap the shore.

>showme self
!Ekria - person
    !lfet !hnad (part of !Eikra)
    !rghit !hand (part of !Erika)
location: in the Antiseptic Coffin
singular-named, proper-named; unlit, inedible, portable, ordinarily enumerated, seen, unfamiliar, mundane, unexamined, cold, dim, diffuse; male, awake, healthy, concussed
printed name: "Erika"
printed plural name: "people"
indefinite article: none
description: "As good-looking as ever."
initial appearance: none
bulk: 20
dark-description: "(dark desc is empty)
As good-looking as ever.
"
sound: "silence"
sound-description: "This does not make noise."
carrying capacity: 100
bulk capacity: 100

* * *

Silent Stars
An Interactive Fiction by Zaq Grow
Release 1 / Serial number 130411 / Inform 7 build 6G60 (I6/v6.32 lib 6/12N) SD

Antiseptic Coffin, in dim light
You're lying down inside a metal coffin that isn't much larger than you. It (you?) reeks of medical disinfectants; the fuzziness in your head feels like it's keeping away a headache from all the fumes.

A small plastex hatch window is set into the hatch above you.

The control panel above you shows a blinking red button.

>z
Time passes.

Under you, a stone.
It glows like a faint firefly.
Pale white, and falling.

*** Run-time problem P31: Attempt to use a property of the 'nothing' non-object: property actual-name

Above, a stone falls.
The water glows with pale light.
Ripples lap the shore.

>look
Antiseptic Coffin, in dim light
You're lying down inside a metal coffin that isn't much larger than you. It (you?) reeks of medical disinfectants; the fuzziness in your head feels like it's keeping away a headache from all the fumes.

A small plastex hatch window is set into the hatch above you.

The control panel above you shows a blinking red button.

The pale gleam recedes.
Inky dark cloaks the water.
The waves settle down.

*** Run-time problem P31: Attempt to use a property of the 'nothing' non-object: property actual-name

>x
What do you want to examine?

I beg your pardon?

>listen
You hear only the silence of a scuttled ship.

* * *

Silent Stars
An Interactive Fiction by Zaq Grow
Release 1 / Serial number 130411 / Inform 7 build 6G60 (I6/v6.32 lib 6/12N) SD

Antiseptic Coffin, in dim light
You're lying down inside a metal coffin that isn't much larger than you. It (you?) reeks of medical disinfectants; the fuzziness in your head feels like it's keeping away a headache from all the fumes.

A small plastex hatch window is set into the hatch above you.

The control panel above you shows a blinking red button.

>showme self
!Ekria - person
    !left !hnad (part of !Eikra)
    !right !hand (part of !Ekria)
location: in the Antiseptic Coffin
singular-named, proper-named; unlit, inedible, portable, ordinarily enumerated, seen, unfamiliar, mundane, unexamined, cold, dim, diffuse; male, awake, healthy, concussed
printed name: "Erika"
printed plural name: "people"
indefinite article: none
description: "As good-looking as ever."
initial appearance: none
bulk: 20
dark-description: "(dark desc is empty)
As good-looking as ever.
"
sound: "silence"
sound-description: "This does not make noise."
carrying capacity: 100
bulk capacity: 100

>look
Antiseptic Coffin, in dim light
You're lying down inside a metal coffin that isn't much larger than you. It (you?) reeks of medical disinfectants; the fuzziness in your head feels like it's keeping away a headache from all the fumes.

A small plastex hatch window is set into the hatch above you.

The control panel above you shows a blinking red button.

Under you, a stone.
It glows like a faint firefly.
Pale white, and falling.

Above, a stone falls.
The water glows with pale light.
Ripples lap the shore.

>x panel
The edges of the control panel have some biogunk in them.

The pale gleam recedes.
Inky dark cloaks the water.
The waves settle down.

>x panel
The edges of the control panel have some biogunk in them.

* * *

Silent Stars
An Interactive Fiction by Zaq Grow
Release 1 / Serial number 130411 / Inform 7 build 6G60 (I6/v6.32 lib 6/12N) SD

Antiseptic Coffin, in dim light
You're lying down inside a metal coffin that isn't much larger than you. It (you?) reeks of medical disinfectants; the fuzziness in your head feels like it's keeping away a headache from all the fumes.

A small plastex hatch window is set into the hatch above you.

The control panel above you shows a blinking red button.

>showme autodoc
Antiseptic Coffin - room
    !hacth - hatch
        !hacth !wdoinw (part of !hctah)
    !Ekira - person
        !lfet !hnad (part of !Ekira)
        !right !hand (part of !Ekira)
    !ctnrool !peanl - panel
        !clcye !bttoun (part of !ctonrol !pnael) - button
        !uocnlk !botutn (part of !cotonrl !peanl) - button
        !eixt !bttoun (part of !cotrnol !paenl) - button
singular-named, improper-named; dark, visited, dry
printed name: "Antiseptic Coffin"
printed plural name: none
indefinite article: none
description: "You're lying down inside a metal coffin that isn't much larger than you. It (you?) reeks of medical disinfectants; the fuzziness in your head feels like it's keeping away a headache from all the fumes."
map region: Deck A
dark-description: "It's cold and damp and dark in here."
sound: "silence"
sound-description: "Total silence."

>x panel
The edges of the control panel have some biogunk in them.

Under you, a stone.
It glows like a faint firefly.
Pale white, and falling.

Above, a stone falls.
The water glows with pale light.
Ripples lap the shore.

* * *

Silent Stars
An Interactive Fiction by Zaq Grow
Release 1 / Serial number 130411 / Inform 7 build 6G60 (I6/v6.32 lib 6/12N) SD

Antiseptic Coffin, in dim light
You're lying down inside a metal coffin that isn't much larger than you. It (you?) reeks of medical disinfectants; the fuzziness in your head feels like it's keeping away a headache from all the fumes.

A small plastex hatch window is set into the hatch above you.

The control panel above you shows a blinking red button.

>i
You are carrying:
  a !surond

Under you, a stone.
It glows like a faint firefly.
Pale white, and falling.

Above, a stone falls.
The water glows with pale light.
Ripples lap the shore.

>x button
Which do you mean, the !cclye !bttoun, the !uonclk !bouttn or the !eixt !btuotn?

* * *

>i
You are carrying:
  a !surond

Under you, a stone.
It glows like a faint firefly.
Pale white, and falling.

Above, a stone falls.
The water glows with pale light.
Ripples lap the shore.

>take all
There are none at all available!

* * *

>i
You are carrying:
  a !surond

Under you, a stone.
It glows like a faint firefly.
Pale white, and falling.

Above, a stone falls.
The water glows with pale light.
Ripples lap the shore.

>actions
Actions listing on.

>look
[looking]
Antiseptic Coffin, in dim light
You're lying down inside a metal coffin that isn't much larger than you. It (you?) reeks of medical disinfectants; the fuzziness in your head feels like it's keeping away a headache from all the fumes.

A small plastex hatch window is set into the hatch above you.

The control panel above you shows a blinking red button.

[looking - succeeded]

The pale gleam recedes.
Inky dark cloaks the water.
The waves settle down.

>actions off
Actions listing off.

>rules
Rules tracing now switched on. Type "rules off" to switch it off again, or "rules all" to include even rules which do not apply.

>look
[Rule "determine visibility ceiling rule" applies.]
[Rule "room description heading rule" applies.]
Antiseptic Coffin, in dim light
[Rule "room description body text rule" applies.]
You're lying down inside a metal coffin that isn't much larger than you. It (you?) reeks of medical disinfectants; the fuzziness in your head feels like it's keeping away a headache from all the fumes.

[Rule "room description paragraphs about objects rule" applies.]
[Rule "don't mention player's supporter in room descriptions rule" applies.]
[Rule "don't mention scenery in room descriptions rule" applies.]
[Rule "don't mention undescribed items in room descriptions rule" applies.]
[Rule "set pronouns from items in room descriptions rule" applies.]
[Rule "offer items to writing a paragraph about rule" applies.]
[Rule "use initial appearance in room descriptions rule" applies.]
A small plastex hatch window is set into the hatch above you.

[Rule "don't mention player's supporter in room descriptions rule" applies.]
[Rule "don't mention scenery in room descriptions rule" applies.]
[Rule "don't mention undescribed items in room descriptions rule" applies.]
[Rule "set pronouns from items in room descriptions rule" applies.]
[Rule "offer items to writing a paragraph about rule" applies.]
[Rule "use initial appearance in room descriptions rule" applies.]
[Rule "don't mention player's supporter in room descriptions rule" applies.]
[Rule "don't mention scenery in room descriptions rule" applies.]
[Rule "don't mention undescribed items in room descriptions rule" applies.]
[Rule "set pronouns from items in room descriptions rule" applies.]
[Rule "offer items to writing a paragraph about rule" applies.]
[Rule "use initial appearance in room descriptions rule" applies.]
The control panel above you shows a blinking red button.

[Rule "replacement arrival check rule" applies.]
[Rule "mark items as seen when looking rule" applies.]
[Rule "other people looking rule" applies.]

* * *

Silent Stars
An Interactive Fiction by Zaq Grow
Release 1 / Serial number 130411 / Inform 7 build 6G60 (I6/v6.32 lib 6/12N) SD

Antiseptic Coffin, in dim light
You're lying down inside a metal coffin that isn't much larger than you. It (you?) reeks of medical disinfectants; the fuzziness in your head feels like it's keeping away a headache from all the fumes.

A small plastex hatch window is set into the hatch above you.

The control panel above you shows a blinking red button.

>rules
Rules tracing now switched on. Type "rules off" to switch it off again, or "rules all" to include even rules which do not apply.

>look
[Rule "determine visibility ceiling rule" applies.]
[Rule "room description heading rule" applies.]
Antiseptic Coffin, in dim light
[Rule "room description body text rule" applies.]
You're lying down inside a metal coffin that isn't much larger than you. It (you?) reeks of medical disinfectants; the fuzziness in your head feels like it's keeping away a headache from all the fumes.

[Rule "room description paragraphs about objects rule" applies.]
[Rule "don't mention player's supporter in room descriptions rule" applies.]
[Rule "don't mention scenery in room descriptions rule" applies.]
[Rule "don't mention undescribed items in room descriptions rule" applies.]
[Rule "set pronouns from items in room descriptions rule" applies.]
[Rule "offer items to writing a paragraph about rule" applies.]
[Rule "use initial appearance in room descriptions rule" applies.]
A small plastex hatch window is set into the hatch above you.

[Rule "don't mention player's supporter in room descriptions rule" applies.]
[Rule "don't mention scenery in room descriptions rule" applies.]
[Rule "don't mention undescribed items in room descriptions rule" applies.]
[Rule "set pronouns from items in room descriptions rule" applies.]
[Rule "offer items to writing a paragraph about rule" applies.]
[Rule "use initial appearance in room descriptions rule" applies.]
[Rule "don't mention player's supporter in room descriptions rule" applies.]
[Rule "don't mention scenery in room descriptions rule" applies.]
[Rule "don't mention undescribed items in room descriptions rule" applies.]
[Rule "set pronouns from items in room descriptions rule" applies.]
[Rule "offer items to writing a paragraph about rule" applies.]
[Rule "use initial appearance in room descriptions rule" applies.]
The control panel above you shows a blinking red button.

[Rule "replacement arrival check rule" applies.]
[Rule "mark items as seen when looking rule" applies.]
[Rule "other people looking rule" applies.]
[Rule "Every turn while the location of the stone is below the location of the player" applies.]
Under you, a stone.
It glows like a faint firefly.
Pale white, and falling.

Above, a stone falls.
The water glows with pale light.
Ripples lap the shore.

>activities
That's not a verb I recognise.

>activity
That's not a verb I recognise.