The smell of burning electronics hits your lizard hindbrain like a rivet gun and you awaken almost immediately, limbs flailing against the sides of the coffin. A badly-milled bolt opens a bloody streak on the back of your wrist, and several seconds pass before you realize you can't feel it because you're completely numb.
 ...
 The smoke smell drifts by your nose again, a little stronger. You startle and bark your forehead on the plastex window above you. The pain keeps you awake this time.

Silent Stars
An Interactive Fiction by Zaq Grow
Release 1 / Serial number 130322 / Inform 7 build 6G60 (I6/v6.32 lib 6/12N) SD

Antiseptic Coffin, in the shadows
You're lying down inside a metal coffin that isn't much larger than you. It (you?) reeks of medical disinfectants; the fuzziness in your head feels like it's keeping away a headache from all the fumes.

A small plastex window is set into the hatch above you.

The control panel above you shows a blinking red button.

The control panel shines on an alarm clock.

>press cycle
The button changes to green and blinks "Completed" a couple times.

* * *

>press exit
A beat passes, and then the gasket on the autodoc's hatch disengages with a whoosh of pressurized air. The stench of old blood quickly replaces the tang of disinfectants.

You open the hatch.

>out
Antiseptic Coffin, in the darkness
The Medical Bay has no description in the dark.

>drop radio
Dropped.

>in
Antiseptic Coffin, in dim light
You're lying down inside a metal coffin that isn't much larger than you. It (you?) reeks of medical disinfectants; the fuzziness in your head feels like it's keeping away a headache from all the fumes.

A small plastex window is set into the hatch above you.

The control panel above you shows a blinking red button.

>listen
neighbors: Medical Bay.
clamorous: radio.
noisy: .

* * *

>listen
neighbors: Medical Bay.
clamorous: radio.
noisy: alarm clock.
final list: radio and alarm clock.

alarm clock and radio
The alarm clock beeps incessantly.
Nearby, the radio emits an unbroken stream of static.

>soundcheck clock
alarm clock:
Is it audible? yes
Noisy
Antiseptic Coffin
alarm clock

* * *

>soundcheck radio'
You can't see any such thing.

>soundcheck radio
You can't see any such thing.

* * *

>soundcheck radio
radio:
Is it audible? yes
Clamorous
Medical Bay
Heard things: alarm clock and radio
Audible things: alarm clock and radio

>soundcheck clock
alarm clock:
Is it audible? yes
Noisy
Antiseptic Coffin
Heard things: alarm clock
Audible things: alarm clock

* * *

>soundcheck radio
radio:
Is it audible? yes
Clamorous
Medical Bay
Heard things: alarm clock and radio
Audible things: alarm clock and radio

>relations
Neighboring relates rooms to each other:
  The Medical Bay  <=>  the Antiseptic Coffin
  Hallway A  <=>  the Medical Bay

* * *

>soundcheck radio
radio:
Is it audible? yes
Clamorous
Medical Bay
Heard things: alarm clock and radio
Audible things: alarm clock and radio

>showme nearby
There seems to be no such object anywhere in the model world.

* * *

>soundcheck radio
radio:
Is it audible? yes
Clamorous
Medical Bay
Heard things: alarm clock and radio
Audible things: alarm clock and radio

>listen
neighbors: Medical Bay.
clamorous: radio.
noisy: alarm clock.
final list: radio and alarm clock.

Nearby, the radio emits an unbroken stream of static.
The alarm clock beeps incessantly.

* * *

>soundcheck alarm clock
alarm clock:
Is it audible? noNoisyAntiseptic Coffin

* * *

>soundcheck clock
alarm clock:
Is it audible? yes
Noisy
Antiseptic Coffin
Other audible things: alarm clock

>relations
Neighboring relates rooms to each other:
  The Medical Bay  <=>  the Antiseptic Coffin
  Hallway A  <=>  the Medical Bay

* * *

>soundcheck clock
alarm clock:
Is it audible? yes
Noisy
Antiseptic Coffin
Other audible things: alarm clock

>soundcheck radio
You can't see any such thing.

* * *

>show relation audibility
You can't see any such thing.

>show relation
You can't see any such thing.

>relations
Neighboring relates rooms to each other:
  The Medical Bay  <=>  the Antiseptic Coffin
  Hallway A  <=>  the Medical Bay

>show relation neighboring
You can't see any such thing.